adapt ova t	RSI
adres ova t	RSI
agit ova t	RSI
akc e	RI
a klim at iz ova t	PRRSSI
alkohol	R
alkohol ik	RS
americ k y	RSI
americ k ý	RSI
amerik a	RI
amerik an iz ova t	RSSSI
amerik án stv í	RSSS
anděl	R
angl ick y	RSI
angl ick ý	RSI
angl ič an	RSS
aranž ova t	RSI
argument	R
asfalt ova t	RSI
asfalt ov ý	RSI
atom	R
atom iz ova t	RSSI
auto mat ick ý	RRSI
auto mat iz ova t	RRSSI
bab ičk a	RSI
babr a t	RSI
baf a t	RSI
bahn i t	RSI
bahn išt ě	RSI
bahn o	RI
bal i t	RSI
bal ík	RS
barv a	RI
barv en ý	RSI
barv i t	RSI
bažin a	RI
bd í t	RSI
bedn i t	RSI
bedýn k a	RSI
belh a t	RSI
beton ova t	RSI
bez po chyb y	RSRI
blaž e n ě	RSSI
blaž i t	RSI
blb nou t	RSI
blesk nou t	RSI
blik a t	RSI
blik nou t	RSI
bli nk a t	RSSI
blok ova t	RSI
bloud	R
bloud i t	RSI
blouzn i l	RSI
blouzn i t	RSI
blud iště	RR
blázen	R
blázn i t	RSI
blázn iv ý	RSI
blázn ovstv í	RSS
blázín ek	RI
blí t	RI
blíž i t	RSI
blýsk a t	RSI
blýsk nou t	RSI
bob ek	RI
bob eček	RS
bod	R
bod a t	RSI
bod nou t	RSI
bod ova t	RSI
boh at nou t	RSSI
boh at stv í	RSSS
boh at ý	RSI
boh at ě	RSI
boh yně	RS
boj	R
boj ova t	RSI
bol e n í	RSSI
bol est	RR
bol est n é	RRSI
bol e t	RSI
bol n ý	RSI
bomb a	RI
bouch a t	RSI
bouch nou t	RSI
bouř i t	RSI
box ova t	RSI
boř i t	RSI
bož sk ý	RSI
bož stv o	RSI
bož stv í	RSS
bož í	RI
brambor	R
brambor a	RI
bratr	R
bratr anec	RS
bratř i t	RSI
bratř íčk ova t	RSSI
breč e t	RSI
brn ě t	RSI
brod iv ost	RSS
broj i t	RSI
brouk a t	RSI
brous i t	RSI
brusl i t	RSI
bruč e t	RSI
brynd a t	RSI
brzd i t	RSI
brách a	RI
brách ův	RI
brán i t	RSI
brázd i t	RSI
buben	R
bubl a t	RSI
bubn ova t	RSI
bud i t	RSI
bud ou c n ost	RSSSS
bud ova t	RSI
buj e t	RSI
buj n ý	RSI
buj n ě	RSI
buj n ě t	RSSI
buš i t	RSI
bydl e t	RSI
by t	RI
by t ov ý	RSSI
by t í	RSS
bád a t	RSI
bád á n í	RSSS
báseň	R
básn i t	RSI
básn ík	RS
bíd a	RI
bíd n ý	RSI
bíd n ě	RSI
bíd ák	RS
bíl i t	RSI
bíl ý	RI
bý t	RI
bý v a t	RSSI
běh	R
běh a t	RSI
běl a t	RSI
běl e t	RSI
běl i t	RSI
běl och	RS
běs n i t	RSSI
běž e t	RSI
břiš n í	RSI
bříš k o	RSI
bůh	R
cap a t	RSI
ced i t	RSI
cement	R
cement ova t	RSI
cen a	RI
cen i t	RSI
cen n ý	RSI
centr al iz ova t	RSSSI
centr ova t	RSI
centr um	RI
cest a	RI
cest ičk a	RSI
cest ova t	RSI
cest ova tel	RSS
cest uj íc í	RSSS
chab nou t	RSI
chap a dl o	RSSI
charakter iz ova t	RSSI
chcíp a t	RSI
chcíp nou t	RSI
checht a t	RSI
chlad nou t	RSI
chlap	R
chlap ec	RI
chlap eč ek	RSI
chlap isk o	RSI
chlap ík	RS
chlast a t	RSI
chlub i l	RSI
chlub i t	RSI
chmel i t	RSI
chod b a	PPI
chod i dl o	PPPI
chod i t	PPI
chod n ík	PPR
chov a n k a	RSSSI
chov a t	RSI
chrapt ě t	RSI
chrchl a t	RSI
chrup a t	RSI
chrup nou t	RSI
chrán ěn ý	RSI
cht ě n í	RSSI
cht ě n ý	RSSI
chud nou t	RSI
chud ák	RS
chud ý	RI
chur av ě t	RSSI
chut n a t	RSSI
chut n á n í	RSSSS
chuť	R
chvál en í	RSI
chvál i t	RSI
chvát a t	RSI
chvě t	RI
chyb i t	RSI
chyb ova t	RSI
chyb ě t	RSI
chyst a t	RSI
chyt a t	RSI
chyt i t	RSI
chyt nou t	RSI
chytr ač i t	RSSI
chytr ák	RS
chytr ý	RI
chytř e	RI
chýl i t	RSI
chův a	RI
cibul e	RI
cink a t	RSI
cit	R
cit eln ý	RSI
cit eln ě	RSI
civil izova n ý	RSSI
civil iz ova t	RSSI
ciz inec	RS
cl o	RI
clon i t	RSI
clon ov ě	RSI
cl í t	RSI
cour a t	RSI
couv a t	RSI
cp á t	RSI
cuc a t	RSI
cuch a t	RSI
cuc nou t	RSI
cuk a t	RSI
cuker n at ě t	RSSSI
cuk nou t	RSI
cukr ova t	RSI
cukr ová n í	RSSS
cukr átk o	RSI
cvak a t	RSI
cvak nou t	RSI
cvič en í	RSI
cvič i t	RSI
cvál a t	RSI
cykl us	RI
cák a t	RSI
cák nou t	RSI
cév k ova t	RSSI
cíl	R
cíl i t	RSI
cín ova t	RSI
cít i t	RSI
cít i teln ý	RSSI
dab ova t	RSI
dareb a	RI
daň ov ý	RSI
dař i t	RSI
debat a	RI
debat ova t	RSI
de centr al iz ova t	PRSSSI
dech nou t	RSI
de fin ova teln ý	RRSSI
de fin ová n í	RRSSS
de form ova t	PRSI
de gener ova t	PRSI
dekor ac e	RSI
dekor ova t	RSI
de mask ova t	PRSI
de moral iz ova t	PRSSI
de norm al iz ac e	PRSSSI
destil ova t	RSI
destil át	RS
dez orient ova t	PRSI
de šifr ova t	PRSI
dikt ova t	RSI
dimenz ova t	RSI
diskut ova t	RSI
div adlo	RR
div och	RS
div ok á	RSI
div oč i t	RSSI
dlab a t	RSI
dloub a t	RSI
dloub nou t	RSI
dluh	R
dluh ova t	RSI
dluž i t	RSI
dlážd i t	RSI
dl í t	RSI
dm ou t	RSI
do belh a t	PRSI
do boj ova t	PRSI
do bouř i t	PRSI
dobr á	RI
dobr ák	RS
dobr ý	RI
do bud ova t	PRSI
do buš i t	PRSI
do by tí	PRR
do bíl i t	PRSI
do bý t	PRI
do bý v a t	PRSSI
do cen i t	PRSI
do ceň ova t	PRSI
do chod i t	PPPI
do chov a t	PRSI
do cház e t	PPPI
do cil ova t	PRSI
do cvál a t	PRSI
do cíl i t	PRSI
do drž e n í	PRSSI
do drž e t	PRSI
do drž ova t	PRSI
do děl a t	PRSI
do dř í t	PRSI
do has nou t	PRSI
do has ín a t	PRSSI
do haz ova t	PRSI
do hled a t	PRSI
do hmát nou t	PRSI
do hod i t	PRSI
do hon i t	PRSI
do hospod ař i t	PRSSI
do hotov i t	PRSI
do hovoř i t	PRSI
do hrab a t	PRSI
do hrá t	PRI
do hvízd a t	PRSI
do hán ě t	PRSI
do hřm í t	PRSI
do hřm ě t	PRSI
do hřá t	PRI
do jedn a t	PRSI
do jedn á v a t	PRSSSI
do jem	PR
do jím a t	PRSI
do jís t	PRI
do jí t	PRI
do jížd ě t	PRSI
do kaz ova t	PRSI
do kaz ová n í	PRSSS
do klep a t	PRSI
do klep á v a t	PRSSSI
do klopýt a t	PRSI
do kol a	PRI
do koléb a t	PRSI
do kolíb a t	PRSI
do kon a l e	PRSSI
do kon a l ost	PRSSS
do kon a t	PRSI
do kon á v a t	PRSSSI
do konč en í	PRSI
do konč i t	PRSI
do konč ova t	PRSI
do kop a t	PRSI
do kos i t	PRSI
do koup i t	PRSI
do kral ova t	PRSI
do kulh a t	PRSI
dokument	R
dokument ova t	RSI
do kup ova t	PRSI
do kvas i t	PRSI
do kvét a t	PRSI
do káz a t	PRSI
do křik nou t	PRSI
do lad i t	PRSI
do let ě t	PRSI
do lož i t	PRSI
do lét a t	PRSI
do lé v a c í	PRSSSI
do lé v a t	PRSSI
do léz a t	PRSI
do léz t	PRI
do léč i t	PRSI
do lí t	PRI
do lít a t	PRSI
do lí v a t	PRSSI
do líz a t	PRSI
do líč i t	PRSI
dom a	RI
do mal ova t	PRSI
do mlouv a t	PRSI
do mluv en ý	PRSI
do mluv i t	PRSI
do mlát i t	PRSI
do ml í t	PRSI
dom ov n ík	RSSS
do mysl e t	PRSI
dom á c í	RSRI
do máh a t	PRSI
do mý t	PRI
do mýšl e t	PRSI
do měř i t	PRSI
do nos i t	PRSI
do nuc ova t	PRSI
do nut i t	PRSI
do náš e t	PRSI
do nés t	PRI
do ob jedn a t	PPRSI
do ob jedn á v a t	PPRSSSI
do o sidl ova t	PPRSI
do o sídl i t	PPRSI
do pad a t	PRSI
do pal ova t	PRSI
do plav i t	PRSI
do plaz i t	PRSI
do pln ěn í	PRSI
do plét a t	PRSI
do plíž i t	PRSI
do plň ova t	PRSI
do po moc i	PPRI
do po ruč en ý	PPRSI
do po ruč i t	PPRSI
do po ruč ova t	PPRSI
do poušt ě t	PRSI
do po víd a t	PPRSI
do po věd ě t	PPRSI
do prac ova t	PRSI
do prac ová v a t	PRSSSI
do pr a t	PRSI
do prav i t	PRSI
do prav ova t	PRSI
do proš ova t	PRSI
do pr á n í	PRSSS
do pt a t	PRSI
do pt á v a t	PRSSSI
do pál en ě	PRSI
do pál i t	PRSI
do pátr a t	PRSI
do pátr á v a t	PRSSSI
do péc i	PRI
do pék a t	PRSI
do pík a t	PRSI
do pín a t	PRSI
do přá t	PRI
do přá v a t	PRSSI
do raz i t	PRSI
do roz um ě n í	PPRSSI
do ruč en í	PRSI
do ruč i t	PRSI
do ruč ova t	PRSI
do rý t	PRI
do sah ova t	PRSI
do sah uj íc í	PRSSI
do saž en í	PRSI
do sch nou t	PRSI
do sek a t	PRSI
do sidl ova t	PRSI
do skoč i t	PRSI
do skák a t	PRSI
do slouž i t	PRSI
do sluh ova t	PRSI
do sn í t	PRSI
do soud i t	PRSI
do sp a t	PRSI
do sp á v a t	PRSSSI
do spí v aj íc í	PRSSSI
do spí v a t	PRSSI
do spě t	PRI
do stač i t	PRSI
do stač i teln ost	PRSSS
do stih	PR
do stih nou t	PRSI
do stih ova t	PRSI
do stoup a n ý	PRSSI
do strk a t	PRSI
do stroj i t	PRSI
do stroj ova t	PRSI
do stud ova t	PRSI
do stá t	PRI
do střel i t	PRSI
do střík a t	PRSI
do suš ova t	PRSI
do syc ova t	PRSI
do syp a t	PRSI
do syp á v a t	PRSSSI
do sídl i t	PRSI
do sýp a t	PRSI
do tah a t	PRSI
do tah ova t	PRSI
do taz ova t	PRSI
do tik a t	PRSI
do tisk nou t	PRSI
do tk nou t	PRSI
do tlač i t	PRSI
do tlouk a t	PRSI
do trh a t	PRSI
do trp ě t	PRSI
do tvoř i t	PRSI
do tvrd i t	PRSI
do tvrz ova t	PRSI
do táh nou t	PRSI
do táz a t	PRSI
do téc i	PRI
do ték a t	PRSI
do těsň ová n í	PRSSS
dou t	RI
do uč i t	PRSI
do uč ova t	PRSI
do vez en ý	PRSI
do vléc i	PRI
do vlék a t	PRSI
do vol a t	PRSI
do vol i t	PRSI
do vol uj íc í	PRSSI
do vol á v a t	PRSSSI
do voz	PR
do vrš i t	PRSI
do vrš ova t	PRSI
do vtíp i t	PRSI
do véz t	PRI
do víd a t	PRSI
do ví t	PRI
do věd ě t	PRSI
do vř í t	PRSI
do zn a t	PRSI
do zn á v a t	PRSSSI
do zn í t	PRSI
do zn í v a t	PRSSSI
do zrá t	PRI
do zrá v a t	PRSSI
do zvon i t	PRSI
do z víd a t	PPRSI
do z věd ě t	PPRSI
do čerp a t	PRSI
do čk a t	PRSI
do řez a t	PRSI
do říc i	PRI
do řík á v a t	PRSSSI
do šláp nou t	PRSI
do šour a t	PRSI
do špin i t	PRSI
do žad ova t	PRSI
do žebr a t	PRSI
do žebr á v a t	PRSSSI
do žr a t	PRSI
do žír a t	PRSI
drah ouš ek	RSI
drah ý	RI
draž i t	RSI
drb a n ý	RSSI
drb a t	RSI
drb nou t	RSI
drk a t	RSI
drk nou t	RSI
drk ot a t	RSSI
drnc a t	RSI
drnc nou t	RSI
drob et	RI
drob i t	RSI
drob n ost	RSS
drob n ý	RSI
drol i t	RSI
drt iv ý	RSI
druh	R
druž i t	RSI
dráh a	RI
dráp a t	RSI
dráp ek	RI
dráp nou t	RSI
drás a t	RSI
drát k ova t	RSSI
drát ova t	RSI
drážd i t	RSI
dráž k ova t	RSSI
drž e t	RSI
duch	R
duch ař	RS
duch ovn í	RSI
duch ov n ě	RSSI
dum a t	RSI
dup a t	RSI
dup nou t	RSI
dup á n í	RSSS
dus a t	RSI
dus i t	RSI
duš e	RI
duš ev n í	RRSI
duš ova t	RSI
dvor ek	RI
dvor n í	RSI
dvoř i t	RSI
dáv i t	RSI
díl	R
díl ek	RI
díl em	RI
díl n a	RSI
dír k a	RSI
dír k ova t	RSSI
dí t	RI
dít ě	RI
dív a t	RSI
dív enk a	RSI
dív k a	RSI
dých a teln ý	RSSI
dých nou t	RSI
dým a t	RSI
dým k a	RSI
děc k o	RSI
děd eček	RS
děd ečk ův	RSI
děd i t	RSI
dě j íc í	RSSI
děk ova t	RSI
děl a t	RSI
děl en ý	RSI
děl i t	RSI
děl ník	RS
děl á n í	RSSS
děl á v a t	RSSSI
dě n í	RSS
děr av ě t	RSSI
děs	R
děs i t	RSI
děs n ý	RSI
děs n ě	RSI
dět in št ě t	RSSSI
dět sk ý	RSI
děv a	RI
děv če	RS
děv č át k o	RSSSI
děť át k o	RSSI
dřev ař sk ý	RSSI
dřev n at ě t	RSSSI
dřev ě n ý	RSSI
dřev ěn ě t	RSSI
dřím a t	RSI
dř í t	RSI
dřív k o	RSI
důl ek	RI
dům	R
dů tk l iv ě	PRSSI
dů věř ova t	PRSI
edit or sk ý	RSSI
elektr ick ý	RSI
elektř in a	RSI
energ et ik a	RSSI
energ et iz ova n ý	RSSSSI
energ i e	RSI
e nerv ova t	PRSI
estet ik a	RSI
evrop sk ý	RSI
exist enc e	RSI
exist enč n í	RSSI
exist ova t	RSI
exist uj íc í	RSSI
experiment ova c í	RSSI
experiment ova t	RSI
ex port n í	RRSI
ex port ova t	RRSI
faleš	R
faleš n ý	RSI
falš ova n ý	RSSI
falš ová n í	RSSS
fax	R
fax ova c í	RSSI
fax ov ý	RSI
faš izova n ý	RSSI
faš iz ova t	RSSI
feder ova t	RSI
fik nou t	RSI
film	R
film ov ý	RSI
filtr ova t	RSI
financ e	RI
financ ová n í	RSSS
finanč n ic tv í	RSSSS
finanč n í	RSI
finanč ník	RS
fint i t	RSI
fix ova t	RSI
flák a t	RSI
flák nou t	RSI
form a	RI
form ač n í	RSSI
form ová n í	RSSS
fouk a t	RSI
fouk nou t	RSI
frk a t	RSI
frk nou t	RSI
fráz ova t	RSI
fréz ova t	RSI
frč e t	RSI
fung ova t	RSI
fung ová n í	RSSS
fung uj íc í	RSSI
funkc e	RI
funkc ion ál n í	RRSSI
fár a t	RSI
fáz e	RI
fňuk a t	RSI
generál n í	RSI
german iz ova t	RSSI
germán sk ý	RSI
gum a	RI
had	R
hal i t	RSI
han a	RI
han b a	RSI
han b i t	RSSI
handl ova t	RSI
han ě t	RSI
harmon ic k ý	RSSI
harmon i e	RSI
harmon iz ova t	RSSI
harmon ova t	RSI
has i č sk ý	RSSSI
has nou t	RSI
hec ova t	RSI
hek a t	RSI
hlad c e	RSI
hlad i t	RSI
hlad k ý	RSI
hlad ov ý	RSI
hlad ov ě t	RSSI
hlas	R
hlas it ě	RSI
hlas ova t	RSI
hlav a	RI
hlav eň	RI
hlav ičk a	RRI
hlav n í	RSI
hlav n ě	RSI
hled a n ý	RSSI
hled a t	RSI
hled isk o	RSI
hled á n í	RSSS
hled í	RS
hled ě t	RSI
hlod a t	RSI
hloub a t	RSI
hloub i t	RSI
hloup nou t	RSI
hloup ý	RI
hlt a t	RSI
hlub oc e	RRI
hlub ok o	RSI
hluch nou t	RSI
hluch ý	RI
hluk	R
hlup ák	RS
hluč e t	RSI
hlás a t	RSI
hlás i t	RSI
hlás k a	RSI
hlás k ova t	RSSI
hlíd a t	RSI
hlíd k ova t	RSSI
hlín a	RI
hmat a t	RSI
hmát nou t	RSI
hni l ob a	RSSI
hnus i t	RSI
hn á t	RSS
hnízd i t	RSI
hnízd o	RI
hněd nou t	RSI
hněd ý	RI
hněv a t	RSI
hobl ova t	RSI
hod n ost n í	RSSSI
hod n ý	RSI
hod n ě	RSS
hol en ě	RSI
hol eň	RS
hol i t	RSI
hol k a	RSI
hol ot a	RSI
holoub ě	RI
holub	R
holub ič k a	RSSI
hol č ičk a	RSSI
hon em	RI
hon i t	RSI
hon i čk a	RSSI
hop k a t	RRSI
hop k ova t	RRSI
horl i t	RSI
hor n í	RSI
hospod ař en í	RSSI
hospod ař i t	RSSI
hospod yn ě	RSI
hospod ář sk ý	RSSI
hospod ář ství	RSS
host	R
host inec	RS
host in sk y	RSSI
host i t	RSI
host ova t	RSI
hotel	R
hotel nic tv í	RSSS
hotov i t	RSI
hotov ý	RI
houb a	RI
houk a t	RSI
houk nou t	RSI
houp a t	RSI
houp a čk a	RSSI
houst nou t	RSI
hovor	R
hovoř i t	RSI
hořk ost	RS
hrab a l	RSI
hrad b a	RSI
hrad eb n í	RSSI
hrad ec	RI
hrad i t	RSI
hrad išt ě	RSI
hran ič i t	RSSI
hrb i t	RSI
hrb áč ův	RSI
hrd in stv í	RSSS
hrk a t	RSI
hrk ot a t	RSSI
hr nou t	RSI
hrnéč ek	RI
hrníč ek	RI
hrob ník ův	RSI
hrom	R
hromad a	RI
hromad i t	RSI
hrom ova t	RSI
hromád k a	RSI
hrot i t	RSI
hroz i t	RSI
hroz n ý	RSI
hroz n ě	RSI
hrub ec	RI
hryz nou t	RSI
hráb nou t	RSI
hrá t	RI
hrá v á n í	RSSSS
hrá č	RS
hrůz a	RI
hub en ý	RSI
hub en ě t	RSSI
hub i t	RSI
hub ičk ova t	RSSI
hub nou t	RSI
hud b a	RSI
hul i t	RSI
hulák a t	RSI
hust i t	RSI
hust ý	RI
hutn ý	RI
hvízd a t	RSI
hvízd nou t	RSI
hvězd ičk a	RSI
hvězd ář	RS
hyzd i t	RSI
hád a t	RSI
hád á n í	RSSS
háj i t	RSI
hák ova t	RSI
ház e t	RSI
háč ek	RI
háč k ova t	RSSI
hýb a t	RSI
hýb á n í	RSSS
hřeš i t	RSI
hřm í t	RSI
hřm ě t	RSI
hřá t	RI
hřích	R
hřím a t	RSI
hříš n ík	RSS
ideal iz ova t	RSSI
ideal iz uj íc í	RSSSI
ideál	R
ideál n í	RSI
ilustr ov an ý	RSSI
index	R
in filtr ova t	PRSI
in form ac e	RRSI
in form ač n í	RRSSI
inov ace	RS
in scen ova t	PRSI
in stal ac e	PRSI
instrument ova t	RSI
integr ova t	RSI
intelekt	R
intelekt uál n í	RSSI
intelekt u ál n ě	RSSSI
intelekt uál sk ý	RSSI
intrik ova t	RSI
izol ov an ost	RSSS
izol ova t	RSI
jadr n ý	RSI
jan k ova t	RSSI
jan k ov sk ý	RSSSI
jan č i t	RSSI
jas n o	RSI
jas n ý	RSI
jas n ě	RSI
jedn a t	RSI
jedn a tel	RSS
jedn ot i t	RRSI
jedn ot liv ec	RSRI
jedn ot liv ost	RSRS
jedn ot liv ý	RRSI
jedn á n í	RSSS
jehl a	RI
je t	RI
jev	R
jev i t	RSI
jev išt ě	RSI
jezd i t	RSI
ječ e t	RSI
jež at ý	RSI
jež i t	RSI
jiskr a	RI
jiskr n ý	RSI
jiskř i t	RSI
jist ot a	RSI
jist ý	RI
jist ě	RI
jmen ova t	RSI
jmen ovit ě	RSI
jmén o	RI
jás a t	RSI
jím a t	RSI
jís t	RI
jí t	RI
jízd a	RI
jízd n í	RSI
jód ova t	RSI
kadeř i t	RSI
kal i t	RSI
kamarád	R
kamarád i t	RSI
kamen ova t	RSI
kamen í	RI
kamen ě t	RSI
kanal iz ova t	RSSI
kanál	R
kap al n i t	RSSSI
kap al n ě t	RSSSI
kapitál n í	RSI
kap ičk a	RSI
kap ičk ov ě	RSSI
kap k a	RSI
kaps ičk a	RSI
kaps ář	RS
kart a	RI
kart ova t	RSI
kartáč ek	RI
kartáč ova t	RSI
kašel	R
kašl a t	RSI
kec a t	RSI
klad iv ář	RSS
klam a t	RSI
klam á n í	RSSS
klap a t	RSI
klap nou t	RSI
klasic k ý	RSI
klek a t	RSI
klek nou t	RSI
klep a t	RSI
klep n a	RSI
klep nou t	RSI
kles nou t	RSI
klest i t	RSI
kleč e t	RSI
klešt i t	RSI
klid	R
klid i t	RSI
klid n ý	RSI
klih ova t	RSI
klik at i t	RSSI
klim a	RI
klim atick ý	RRI
klon i t	RSI
klop i t	RSI
klopýt a t	RSI
klopýt av ě	RSI
kloub i t	RSI
klouz a t	RSI
klov a t	RSI
klov nou t	RSI
klub a t	RSI
klus a t	RSI
klábos i t	RSI
klás t	RI
klát i t	RSI
klín	R
klín ova t	RSI
klí t	RI
klíč	R
klíč i t	RSI
klíž i t	RSI
kmit a t	RSI
kmit nou t	RSI
knih ova t	RSI
knih ovn a	RSI
kníž e	RI
kníž k a	RSI
koc ouř í	RSI
kodrc a t	RSI
koj en ec	RSI
koj i t	RSI
koj n á	RSI
kokt a l	RSI
kokt a t	RSI
ko labor ova t	PRSI
koled ova t	RSI
kol em	RI
kol k ova t	RSSI
kol o	RI
kolon iz ova t	RRSI
kol ova t	RSI
koléb a t	RSI
kolíb a t	RSI
kol ík ova t	RSSI
kombin ac e	RSI
kombin ova n ý	RSSI
koment ova t	RSI
koment át or	RSS
komor a	RI
komor n ík	RSS
kompil ova t	RSI
kom pon ova t	RRSI
kompost ova t	RSI
komun ik ac e	RRSI
kon a t	RSI
konc ov ě	RSI
kondenz átor	RS
konec	R
konejš i t	RSI
koneč ek	RI
koneč n ík	RSS
koneč n ě	RSS
kon feder ova t	PRSI
kon sign ova t	PRSI
kon struk c e	RRSI
kontrol a	RI
kontrol ova t	RSI
konzult ac e	RSI
konzult ova t	RSI
kon íčk ova t	RSSI
ko oper ac e	PRSI
ko oper ova t	PRSI
ko ordin ova t	PRSI
kop a nec	RSS
kop nou t	RSI
kor a t	RSI
ko rmout i t	PRSI
kor n at ě t	RSSSI
kos i t	RSI
kost	R
kost ičk a	RSI
kost n at ě t	RSSSI
kost ra	RI
kotv a	RI
kotv i t	RSI
kot ě	RI
kouk a t	RSI
koul e	RI
koul e t	RSI
koul ova t	RSI
koup el	RS
koup i t	RSI
koup á n í	RSSS
koup ě	RI
kous a t	RSI
kous nou t	RSI
kouzel n ic e	RSSI
kouzel n ík	RSS
kouzl i t	RSI
kouzl o	RI
kouř i t	RSI
koč ič í	RSI
koč k ova t	RSSI
koč ova t	RSI
koč í	RI
kořen i t	RSI
kořist	R
kořist i t	RSI
kož en ý	RSI
kraj an	RS
kraj n ost	RSS
kraj án ek	RSI
kral ova t	RSI
kral ová n í	RSSS
kram ař i t	RSSI
kras av ic e	RSSI
krev	R
krev n í	RSI
krk a t	RSI
krk nou t	RSI
krm i t	RSI
krok	R
krok em	RI
krop i t	RSI
krot i t	RSI
krot nou t	RSI
krouh a t	RSI
krout i t	RSI
krouž ek	RI
krouž k ova t	RSSI
kruh	R
kruš i t	RSI
krv av ý	RSI
krv ác e t	RSSI
krystal ova t	RSI
kry t í	RSI
krád ež	RS
kráj e t	RSI
král k a	RSI
král ov n a	RSSI
král ov sk ý	RSSI
král ov stv í	RSSS
král ův	RI
krám ek	RI
krám y	RI
krás a	RI
krás n ě	RSI
krás n ě t	RSSI
krás t	RI
krát c e	RSI
krát i t	RSI
krát k ý	RSI
kráč e t	RSI
kráš l ic í	RSSI
kráš l i t	RSSI
krý t	RI
krč i t	RSI
kuch a t	RSI
kuk a t	RSI
kul at ě t	RSSI
kulh a t	RSI
kulh a v ý	RSSI
kul i t	RSI
kult iv ova t	RSSI
kult ur a	RSI
kult ur n ost	RSSS
kult ur n í	RSSI
kup a	RI
kup i t	RSI
kup k ova t	RSSI
kup ova t	RSI
kut a t	RSI
kut i t	RSI
kutál e t	RSI
kuř ác k ý	RSSI
kvap i t	RSI
kvas i t	RSI
kvet ou c í	RSSI
kyd a t	RSI
kyp ě t	RSI
kys a t	RSI
kys el i t	RRSI
kys nou t	RSI
kác e t	RSI
kál e t	RSI
kámen	R
kár a t	RSI
ká t	RI
káz a t	RSI
kód	R
kýv a t	RSI
kýv nu t í	RSSI
křeh k ý	RSI
křeh nou t	RSI
křes a t	RSI
křes nou t	RSI
křesť an sk y	RSSI
křik	R
křik nou t	RSI
křiv i t	RSI
křiv k a	RSI
křič e t	RSI
křiž ova t	RSI
křup a t	RSI
křup nou t	RSI
křáp a t	RSI
křáp nou t	RSI
křís nou t	RSI
kříž	R
kříž ek	RI
kříž i t	RSI
kříž k ova t	RSSI
kříž ovník ův	RSI
kříž ov ý	RSI
kůl n ičk a	RSSI
kůň	R
kůž e	RI
kůž ičk a	RSI
labor ova t	RSI
lad i t	RSI
lad ěn í	RSI
lahod i t	RSI
lak ýr ová n í	RSSSS
lan ař i t	RSSI
lap a t	RSI
lap i t	RSI
lap nou t	RSI
lask a t	RSI
lask av ý	RSI
lask a v ě	RSSI
latin sk y	RSI
lecht a t	RSI
led	R
led ova t	RSI
led ov ec	RSI
led ov ý	RSI
led ov ě	RSI
legitim n í	RSI
legitim ova n ý	RSSI
legitim ova t	RSI
legál ní	RS
lek a t	RSI
lek nou t	RSI
lem ova t	RSI
len i t	RSI
len och	RS
len ost	RS
lept a t	RSI
lesk l ý	RSI
lesk nou t	RSI
les n í	RSI
let	R
let a dl o	RSSI
let ec k ý	RSSI
let it ý	RSI
let n í	RSI
let os	RS
let áč ek	RSI
lev ý	RI
lešt i t	RSI
lež	R
liberal iz ac e	RSSI
lichot i t	RSI
lid ov ý	RSI
lid sk y	RSI
likvid ac e	RSI
likvid ova t	RSI
limit ova t	RSI
lini e	RI
lis ova t	RSI
list	R
list ova t	RSI
lit ova t	RSI
liš en í	RSI
lod ičk a	RSI
lok al iz ova t	RSSSI
lok ální	RS
lom i t	RSI
los	R
los ova t	RSI
loud a t	RSI
loud i t	RSI
louh ova t	RSI
loup a t	RSI
loup ež i t	RSSI
loup ež n ic tv í	RSSSSS
loup ež n ík	RSSS
loup i t	RSI
loup nou t	RSI
lousk a t	RSI
lousk nou t	RSI
loutk ař	RS
louč i t	RSI
louž i t	RSI
lov ec	RI
lov ec k ý	RSSI
lov i t	RSI
loď	R
lož i t	RSI
lup i č	RSS
lušt i t	RSI
lyž ař i t	RSSI
lyž ova t	RSI
lák a t	RSI
lám a t	RSI
lát a t	RSI
lék	R
lék ař	RS
lét a t	RSI
lét o	RI
léz t	RI
léč b a	RSI
léč i t	RSI
líb nou t	RSI
lím ec	RI
lín a t	RSI
lí t	RI
lít a t	RSI
líz a l	RSI
líz a t	RSI
líč i t	RSI
mach	R
magnet iz ova t	RSSI
magnet ova t	RSI
mal in k ý	RSSI
mal ičk o	RSI
mal ičk ost	RSS
mal íř	RS
mal íř stv í	RSSS
manévr ova t	RSI
map ova t	RSI
mar n ě	RSI
marod i t	RSI
mask a	RI
mask ova t	RSI
mast i t	RSI
mas áž	RS
mas ér	RS
mas ír ova t	RSSI
mater i ál	RSI
matl a t	RSI
mat ou c í	RSSI
maz a t	RSI
maz a v k a	RSSSI
mazl i t	RSI
maďar sk ý	RSI
mař i t	RSI
mašt ěn í	RSI
mdl í t	RSI
mechan ist ick ý	RRRI
mechan iz ova t	RRSI
medit ač n í	RSSI
med ova t	RSI
medvíd ek	RI
medvíd ě	RI
medvěd	R
mejl k a	RSI
mek ot a t	RSSI
mel a	RI
meč e t	RSI
mešk a t	RSI
mhouř i t	RSI
mil e	RI
mil en ec	RSI
mil k ova t	RSSI
mil ost iv ý	RSSI
mil ost n ý	RSSI
mil ova t	RSI
mil ová n í	RSSS
mil áček	RS
mil ý	RI
minerál n í	RSI
ministr	R
ministr ův	RI
mix ova t	RSI
miz e t	RSI
miz in a	RSI
mlad i t	RSI
mlad ík	RS
mlad ý	RI
mlad ě	RI
mlask nou t	RSI
mls a t	RSI
mluv i t	RSI
mlád nou t	RSI
mlád í	RS
mlád ě	RI
mlát i t	RSI
mláz í	RS
mlék o	RI
mléč n ý	RSI
mlík o	RI
ml í t	RSI
mlíč k o	RSI
ml ýn	RS
mlč e n í	RSSI
mlč e t	RSI
mlž i t	RSI
mnoh d y	RRI
mnoh o	RI
mnoh ost	RS
mnoh ý	RI
množ i t	RSI
moc	R
moc i	RI
moc n i t	RSSI
moc n ost	RSS
moc n ý	RSI
moc n ě	RSI
model	R
model ova n ost	RSSS
moder ova t	RSI
modr ý	RI
modř i t	RSI
mok nou t	RSI
mok r o	RSI
mont ova t	RSI
mont ér	RS
moral iz ova t	RSSI
mord ova t	RSI
mord ýř	RS
morál n í	RSI
most	R
mot a t	RSI
motiv ac e	RSI
motiv ov an ý	RSSI
motiv ova t	RSI
motor	R
motor ov ý	RSI
moudr ost	RS
moudr ý	RI
moudř e	RI
moč i t	RSI
moř e	RI
moř i t	RSI
mrav n í	RSI
mraz i t	RSI
mrač i t	RSI
mrh a t	RSI
mrk a t	RSI
mrsk a t	RSI
mrsk nou t	RSI
mrtv ol n ý	RSSI
mrtv ý	RI
mrz ač i t	RSSI
mrz nou t	RSI
mrz ut ě	RSI
mráz	R
mršt i t	RSI
mst i v ě	RSSI
mst í t	RSI
muchl a t	RSI
muchl ova t	RSI
muk a	RI
mut ova t	RSI
muzik a	RI
muč írn a	RSI
muž	R
muž n ý	RSI
muž n ě t	RSSI
muž sk ý	RSI
muž stv í	RSS
myk a t	RSI
myk nou t	RSI
mysl	R
mysl e t	RSI
mysl i t	RSI
mysl i tel stv í	RSRSS
my t í	RSI
myšl e n k a	RSSSI
myšl en k ov ý	RSSSI
myšl e n í	RSSI
mách a t	RSI
mák nou t	RSI
mál o	RI
mám i t	RSI
máv aj íc í	RSSI
máv a t	RSI
máv nou t	RSI
máz nou t	RSI
máč e t	RSI
mích a t	RSI
míj e t	RSI
mín ěn í	RSI
míst ečk o	RSI
míst o	RS
míř i t	RSI
mód a	RI
mýl i t	RSI
mý t	RS
mýt in a	RSI
mýt i t	RSI
měk c e	RSI
měk nou t	RSI
měn a	RI
měn i t	RSI
měn ový	RS
měst ečk o	RSI
měst o	RI
měst sk ý	RSI
mř í t	RSI
mříž	R
mříž k ova t	RSSI
na bal i t	PRSI
na barv i t	PRSI
na blýsk á n í	PRSSS
na bod nou t	PRSI
na bouch a t	PRSI
na bour a t	PRSI
na bíl i t	PRSI
na bý t	PRI
na běh a t	PRSI
na chlad i t	PRSI
na chlad nou t	PRSI
na chlast a t	PRSI
na chmel i t	PRSI
na chod i t	PPPI
na chyst a t	PRSI
na chyt a t	PRSI
na cház e t	PPPI
na chýl i t	PRSI
nac ism us	RRI
nac ist ick ý	RRSI
na cp a t	PRSI
na cp á v a t	PRSSSI
na cuc a t	PRSI
na cvič i t	PRSI
na cvič ova t	PRSI
na cák a t	PRSI
na cák nou t	PRSI
nad cen i t	PRSI
na dch nou t	PRSI
na dech nou t	PRSI
na dech ova t	PRSI
nade je t	PRI
nade zd í t	PRSI
nade zd í v a t	PRSSSI
nad haz ova t	PRSI
nad hled	PR
nad hod i t	PRSI
na dikt ova t	PRSI
nad je t	PRI
nad jížd ě t	PRSI
na dm ou t	PRSI
nad náš e t	PRSI
nad nés t	PRI
na doj i t	PRSI
na dou t	PRI
nad po ruč ík ov á	PPRSSI
nad pro duk c e	PPRSI
na drob en ý	PRSI
na drob i t	PRSI
na dráp a t	PRSI
na drát ova n ě	PRSSI
na drž e t	PRSI
na drž ova t	PRSI
nad skak ova t	PRSI
nad skoč i t	PRSI
na duř e t	PRSI
na dych ova t	PRSI
nad zdvih nou t	PRSI
nad z ved nou t	PPRSI
na díl e t	PRSI
na dí v a t	PRSSI
na dých a t	PRSI
na dých nou t	PRSI
na děl a t	PRSI
na děl i t	PRSI
na děl ova t	PRSI
na děr ova t	PRSI
nad řad i t	PRSI
nad řaz ova t	PRSI
na fint i t	PRSI
na flák a t	PRSI
na fouk a t	PRSI
na fuk ova t	PRSI
na gum ova t	PRSI
na hled a t	PRSI
na hlod a t	PRSI
na hlt a t	PRSI
na hlás it	PRI
na hlíd a t	PRSI
na hmat a t	PRSI
na hmát nou t	PRSI
na hní t	PRI
na hní v a t	PRSSI
na hněv a t	PRSI
na hon i t	PRSI
na hospod ař i t	PRSSI
na hrab a t	PRSI
na hrab ova t	PRSI
na hrad i t	PRSI
na hrad i teln ost	PRSSS
na hr nou t	PRSI
na hromad i t	PRSI
na hryz a t	PRSI
na hryz nou t	PRSI
na hrá t	PRI
na hrá v a t	PRSSI
na hust i t	PRSI
na ház e t	PRSI
nah áč	RS
nah ý	RI
na hřá t	PRI
na in stal ova t	PPRSI
na je t	PRI
na jezd i t	PRSI
na jež i t	PRSI
na jmen ova t	PRSI
na jím a t	PRSI
na jí t	PRI
na jížd ě t	PRSI
na kadeř i t	PRSI
na kap a t	PRSI
na kaz i t	PRSI
na kec a t	PRSI
na klad a tel stv í	PRSSSI
na klep a t	PRSI
na klep á v a t	PRSSSI
na klon ěn ý	PRSI
na kloň ova t	PRSI
na klábos i t	PRSI
na klád a t	PRSI
na klád á n í	PRSSS
na klán ě t	PRSI
na klíč i t	PRSI
na klíž i t	PRSI
na komand ova t	PRSI
na konec	PR
na kop a t	PRSI
na kop nou t	PRSI
na kop á v a t	PRSSSI
na kouk a t	PRSI
na kouk nou t	PRSI
na koup i t	PRSI
na kous nou t	PRSI
na kouř i t	PRSI
na kořist i t	PRSI
na krm i t	PRSI
na krop i t	PRSI
na kruc ova t	PRSI
na kráj e t	PRSI
na krč i t	PRSI
na kuk a t	PRSI
na kuk ova t	PRSI
na kup i t	PRSI
na kup ova t	PRSI
na kvas i t	PRSI
na kvaš ova t	PRSI
na kyd a t	PRSI
na kyp ě t	PRSI
na kys a t	PRSI
na kys l e	PRSI
na kys nou t	PRSI
na kác e t	PRSI
na káz a t	PRSI
na křiv i t	PRSI
na křiv ova t	PRSI
na křáp nou t	PRSI
na lad i t	PRSI
na lak ova n ý	PRSSI
na lak ova t	PRSI
na lap a t	PRSI
na len oš i t	PRSSI
na lept a t	PRSI
na let ova t	PRSI
na let ě t	PRSI
na lev o	PRI
na lešt i t	PRSI
na lh a t	PRSI
na lh á v a t	PRSSSI
na lom i t	PRSI
na loup a t	PRSI
na loup nou t	PRSI
na lov i t	PRSI
na lož i t	PRSI
na lám a t	PRSI
na lé v a t	PRSSI
na léz a t	PRSI
na lí t	PRI
na lít a t	PRSI
na lí v a t	PRSSI
na líz nou t	PRSI
na líč i t	PRSI
na mak a t	PRSI
na mal ova t	PRSI
na mask ova t	PRSI
na mast i t	PRSI
na mas ír ova t	PRSSI
na maz a t	PRSI
na mačk a t	PRSI
na mlouv a t	PRSI
na mls a t	PRSI
na mluv i t	PRSI
na mlát i t	PRSI
na ml í t	PRSI
na mnoz e	PRI
na moc i	PRI
na modř i t	PRSI
na mont ova t	PRSI
na mot a t	PRSI
na mot á v a t	PRSSSI
na moř i t	PRSI
na mrsk a t	PRSI
na mysl e t	PRSI
na mysl i t	PRSI
na máh a t	PRSI
na mák nou t	PRSI
na máz nou t	PRSI
na máč e t	PRSI
na míř i t	PRSI
na měk nou t	PRSI
na měř i t	PRSI
na nos i t	PRSI
na náš e t	PRSI
na nés t	PRI
na ob těž ova t	PPRSI
na olej ova t	PRSI
na ostř i t	PRSI
na pad a t	PRSI
na pad nou t	PRSI
na pad á v a t	PRSSSI
na parfém ova t	PRSI
na par ova t	PRSI
na parád i t	PRSI
na pař i t	PRSI
na pař ova t	PRSI
na pich ova t	PRSI
na pil ova t	PRSI
na pj a t ý	PRSSI
na plak a t	PRSI
na plat i t	PRSI
na plav ova t	PRSI
na plesk a t	PRSI
na pliv nou t	PRSI
na pln i t	PRSI
na plác a t	PRSI
na plán ova t	PRSI
na plét a t	PRSI
na plí t	PRI
na po hlav k ova t	PPRSSI
na po moc i	PPRI
na po rouč e t	PPRSI
na po smí v a t	PPRSSI
na po síl a t	PPRSI
na poušt ě t	PRSI
na po víd a t	PPRSI
na po věd ě t	PPRSI
na prac ová v a t	PRSSSI
na prav i t	PRSI
na prav ova t	PRSI
na pros i t	PRSI
na prásk a t	PRSI
na práš i t	PRSI
na prš e t	PRSI
na ps a t	PRSI
na puk nou t	PRSI
na pump ova t	PRSI
na pust i t	PRSI
na put ova t	PRSI
na pách a t	PRSI
na pál i t	PRSI
na pás t	PRI
na péc i	PRI
na pích a t	PRSI
na pín a t	PRSI
na písk a t	PRSI
na pěch ova t	PRSI
na pěn i t	PRSI
na přim ova t	PRSI
na přím i t	PRSI
na raz i t	PRSI
na rob i t	PRSI
na rod i t	PRSI
na roub ova t	PRSI
na roz en ý	PRSI
na ruš i t	PRSI
na ruš ova t	PRSI
na rv a t	PRSI
na ráž e t	PRSI
na rýp a t	PRSI
na rýs ova t	PRSI
na sak ova t	PRSI
na sed ě t	PRSI
na sek a t	PRSI
na sek nou t	PRSI
na s hromážd i t	PPRSI
na s hán ě t	PPRSI
na skak ova t	PRSI
na s klád a t	PRRSI
na skoč i t	PRSI
na skák a t	PRSI
na slin i t	PRSI
na slouch a t	PRSI
na slouž i t	PRSI
na sluh ova t	PRSI
na smá t	PRI
na s níd a t	PPRSI
na sol i t	PRSI
na souk a t	PRSI
na souk á v a t	PRSSSI
na spoř i t	PRSI
na star a t	PRSI
na start ova t	PRSI
na sta t	PRI
na steh ova t	PRSI
na stiň ova t	PRSI
na stoup i t	PRSI
na strach ova t	PRSI
na straš i t	PRSI
na strk a t	PRSI
na strk ova t	PRSI
na strk á v a t	PRSSSI
na stroj i t	PRSI
na stroj ova t	PRSI
na strouh a t	PRSI
na strč i t	PRSI
na stud i t	PRSI
na stud ova t	PRSI
na stup ova t	PRSI
na styd nou t	PRSI
na stá t	PRI
na stín i t	PRSI
na stěh ová v a t	PRSSSI
na střik ova t	PRSI
na střád a t	PRSI
na střík a t	PRSI
na střík nou t	PRSI
na střík á v a t	PRSSSI
na stříl e t	PRSI
na svač i t	PRSI
na svíc en í	PRSI
na syc ova t	PRSI
na syp a t	PRSI
na syp á v a t	PRSSSI
na sá t	PRI
na sá v a t	PRSSI
na tah uj íc í	PRSSI
na tanc ova t	PRSI
na tisk nou t	PRSI
na tlach a t	PRSI
na tlač i t	PRSI
na tlouc i	PRI
na tlouk a t	PRSI
na toul a t	PRSI
na touž i t	PRSI
na toč i t	PRSI
na tref i t	PRSI
na trh a t	PRSI
na trh nou t	PRSI
na trh á v a t	PRSSSI
na troub i t	PRSI
na trous i t	PRSI
na táč e t	PRSI
na téc i	PRI
na ték a t	PRSI
na tír a t	PRSI
na týr a t	PRSI
na těsn a t	PRSI
na těš i t	PRSI
na třep a t	PRSI
na třás a t	PRSI
na třás t	PRI
na třísk nou t	PRSI
na tř í t	PRSI
na uč en í	PRSI
na uč i t	PRSI
na val ova t	PRSI
na vaz ova t	PRSI
na vař i t	PRSI
na verb ova t	PRSI
na večeř e t	PRSI
na vlas	PR
na vlaž i t	PRSI
na vlaž ova t	PRSI
na vlh nou t	PRSI
na vlh č i t	PRSSI
na vlh č ova t	PRSSI
na vléc i	PRI
na vlék a t	PRSI
na vlík a t	PRSI
na vol a t	PRSI
na von ě t	PRSI
na vosk ova t	PRSI
na voz i t	PRSI
na vrac e t	PRSI
na vrh ova t	PRSI
na vrstv i t	PRSI
na vrt a t	PRSI
na vrt ě t	PRSI
na vrát i t	PRSI
na vy mýšl e t	PPRSI
na vy pt á v a t	PPRSSSI
na vál e t	PRSI
na vá t	PRI
na váz a t	PRSI
na váz á n í	PRSSS
na váž e t	PRSI
na ví t	PRI
na věs i t	PRSI
na věš e t	PRSI
navštív en ý	RSI
navštív i t	RSI
navštěv ova t	RSI
na zdvih nou t	PRSI
na zdvih ova t	PRSI
naz e	RI
na zelen i t	PRSI
na zl ob i t	PRSSI
na znak	PR
na znač i t	PRSI
na znač ova t	PRSI
na zou t	PRI
na zv a t	PRSI
na čad i t	PRSI
na čap a t	PRSI
na ček a t	PRSI
na čep ova t	PRSI
na čepýř i t	PRSI
na čern i t	PRSI
na čerp a t	PRSI
na čerp á v a t	PRSSSI
na červen i t	PRSI
na čerň ova t	PRSI
na čes a t	PRSI
na čes á v a t	PRSSSI
na čich á v a t	PRSSSI
na čmár a t	PRSI
na čoud i t	PRSI
na čp ě t	PRSI
na čuch a t	PRSI
na čuch nou t	PRSI
na řas ova t	PRSI
na řez a t	PRSI
na řez á v a t	PRSSSI
na řiz ova t	PRSI
na řk nou t	PRSI
na řv a t	PRSI
na říd i t	PRSI
na říz k ová n í	PRSSSS
na říz nou t	PRSI
na šept a t	PRSI
na šetř i t	PRSI
na škrob i t	PRSI
na šlap a t	PRSI
na šlap ova t	PRSI
na šlap á v a t	PRSSSI
na šleh a t	PRSI
na špendl i t	PRSI
na špik ova t	PRSI
na špin i t	PRSI
na šroub ova t	PRSI
na štv a t	PRSI
na štíp a t	PRSI
na štíp nou t	PRSI
na štěp ova t	PRSI
na štěst í	PRI
na švih a t	PRSI
na švih nou t	PRSI
na ší t	PRI
na ší v a t	PRSSI
na šťouch a t	PRSI
na šťouch nou t	PRSI
na ťap a t	PRSI
na ťuk nou t	PRSI
na žr a t	PRSI
na žvatl a t	PRSI
na ží t	PRI
ne blah ý	IRI
nech a t	RSI
ne chuť	IR
nech á v a t	RSSSI
ne děl e	IRI
ne mluv n ý	IRSI
ne mluv n ě	IRSI
ne mluv ň át k o	IRSSSI
ne moc	IR
ne moc nic e	IRSI
ne na syt n ý	IPRSI
ne ná vid ě t	IPRSI
ne patr n ý	IRSI
ne po chyb n ě	IPRSS
ne ruš en ý	IRSI
neuróz a	RI
ne vol n o	IRSI
ne víd a n ý	IRSSI
ne řád	IR
nič i t	RSI
noh a	RI
noh av ic e	RSSI
nomin ova t	RSI
norm a	RI
norm al iz ač n í	RSSSSI
norm al iz ova n ý	RSSSSI
norm al iz ova t	RSSSI
norm ova t	RSI
norm ál n í	RSSI
nos	R
nos i t	RSI
not ova t	RSI
novel iz ova t	RSSI
nov in y	RSI
nov in ář	RSS
nov ý	RI
nov ě	RI
noč n í	RSI
nud i t	RSS
nut i t	RSI
nut k a t	RSSI
nut n ý	RSI
nut n ě	RSI
nuz ova t	RSI
ná bož en sk ý	PRSSI
ná bož en stv í	PRSSS
ná draž n í	PRSI
ná draž í	PRI
ná jem n é	PRSI
ná jem n í	PRSI
ná kup	PR
ná kup n í	PRSI
ná lad a	PRI
ná moř n ík	PRSS
ná měst í	PRI
ná pad n ý	PRSI
ná pad n ě	PRSI
ná prs n í	PRSI
ná rod n í	PRSI
ná rok	PR
ná roč n ý	RRSI
ná sil í	PRS
ná sled ek	PRI
ná sled ov an ý	PRSSI
ná sled ova t	PRSI
ná sled ov ník	PRSS
ná stup	PR
ná vrat	PR
ná vrh	PR
nés t	RI
níz k o	RSI
níz ký	RI
nýt ova t	RSI
o bahn i t	PRSI
o bal i t	PRSI
o bal ova t	PRSI
o barv i t	PRSI
o barv ova n ý	PRSSI
ob cház e t	PPPI
ob dař i t	PRSI
ob dař ova t	PRSI
ob děl a t	PRSI
ob děl á v a t	PRSSSI
o bedn i t	PRSI
obe hrá t	PRI
obe hrá v a t	PRSSI
obe pín a t	PRSI
obe zd í t	PRSI
obe zd í v a t	PRSSSI
ob haj ob a	PRSI
ob haj ova t	PRSI
ob hospod ař i t	PRSSI
ob hospod ař ova t	PRSSI
ob háj i t	PRSI
ob háč k ova t	PRSSI
ob jedn á v a t	PRSSSI
ob jev	PR
ob jev i t	PRSI
ob jezd i t	PRSI
ob jížd ě t	PRSI
ob klič ova t	PRSI
ob klop i t	PRSI
ob klop ova t	PRSI
ob klíč i t	PRSI
ob krouž i t	PRSI
o blaž i t	PRSI
o blb ova t	PRSI
ob lek	PR
ob leč en ý	PRSI
ob liz ova t	PRSI
ob loh a	PRI
ob lom i t	PRSI
ob loud i t	PRSI
ob lož i t	PRSI
ob léc i	PRI
ob lék an ý	PRSI
ob lék nou t	PRSI
ob lék á n í	PRSSS
ob lé v a t	PRSSI
ob léz a t	PRSI
ob léz t	PRI
ob lí t	PRI
ob lí v a t	PRSSI
ob líz a t	PRSI
ob líz nou t	PRSI
ob mysl i t	PRSI
ob mý t	PRI
ob měk č i t	PRSSI
ob měn a	PRI
ob měn i t	PRSI
ob měň ova t	PRSI
ob naž ova t	PRSI
ob nos i t	PRSI
ob nov a	PRI
ob nov en í	PRSI
ob nov ova t	PRSI
o bol av ě t	PRSSI
o boř i t	PRSI
o boř ova t	PRSI
ob rac e t	PRSI
ob rat el	PRI
ob raz	PR
ob raz ec	PRI
ob raz i t	PRSI
ob raz ov k a	PRSSI
ob raz ov ý	PRSI
o brn i t	PRSI
ob rod i t	PRSI
ob rod i tel sk ý	PRSSSI
ob roz ova t	PRSI
ob rác e n ě	PRSSS
o brán i t	PRSI
ob rát i t	PRSI
ob ráz ek	PRI
ob rý t	PRI
ob růst a t	PRSI
ob sah ova t	PRSI
ob sek a t	PRSI
ob sek á v a t	PRSSSI
ob skak ova t	PRSI
ob slouž i t	PRSI
ob sluh ova t	PRSI
ob star a t	PRSI
ob stá t	PRI
ob syp a t	PRSI
ob syp á v a t	PRSSSI
ob sáh l ý	PRSI
ob sáh nou t	PRSI
ob tah ova t	PRSI
ob tanč i t	PRSI
ob tisk nou t	PRSI
ob tisk ova t	PRSI
ob toč i t	PRSI
ob táh nou t	PRSI
ob táč e t	PRSI
ob téc i	PRI
ob ték a t	PRSI
ob tíž	PR
ob tíž i t	PRSI
ob těž k a t	PRSSI
ob těž k á v a t	PRSSSSI
ob těž ova t	PRSI
ob vesel ova t	PRSI
ob vin i t	PRSI
ob viň ova t	PRSI
ob váz a t	PRSI
o by v a tel	PRSSI
o bál k a	PRSI
o bíh a t	RRSI
o bíl i t	PRSI
o bý v a t	PRSSI
obč an	RS
ob čas n ý	PRSI
o běh a t	PRSI
o běh nou t	RRSI
o běh ov ý	PRSI
obět ová n í	RSSS
oběť	R
o běž n ý	PRSI
ob řez a t	PRSI
ob říz nou t	PRSI
ob ší t	PRI
ob ší v a t	PRSSI
ob žal ova t	PRSI
ocel	R
ocel ov ý	RSI
o cen i t	PRSI
o ceň ova t	PRSI
o chab nou t	PRSI
o chab nu t í	PRSSI
o chab ova t	PRSI
o chlad i t	PRSI
o chlad nou t	PRSI
o chlaz ení	PRS
o chlaz ova t	PRSI
o chmel i t	PRSI
o choř e t	PRSI
o chran a	PRI
o chran i tel sk y	PRSSSI
o chrapt ě l ý	PRSSI
o chrapt ě t	PRSI
o chraň ova t	PRSI
o chud i t	PRSI
o chut n a t	PRSSI
o chuz ova t	PRSI
o cit ova t	PRSI
o cuc á v a t	PRSSSI
o cukr ova t	PRSI
od barv i t	PRSI
od bav i t	PRSI
od bav ova t	PRSI
od belh a t	PRSI
od belh á v a t	PRSSSI
od bour a t	PRSI
od boč i t	PRSI
od brzd i t	PRSI
od bý t	PRI
od bý v a t	PRSSI
od cest ova t	PRSI
od chov a t	PRSI
od chov á v a t	PRSSSI
od chrchl a t	PRSI
od chvát a t	PRSI
od chyl ova t	PRSI
od cház e t	PPPI
od chýl i t	PRSI
od ciz i t	PRSI
od clon i t	PRSI
od cloň ova t	PRSI
od cvál a t	PRSI
od dech nou t	PRSI
od dech ova t	PRSI
od diskut ova t	PRSI
od drob i t	PRSI
od drob ova t	PRSI
od drol i t	PRSI
od drol ova t	PRSI
od dych nou t	PRSI
od dych ova t	PRSI
od děl a t	PRSI
od děl en í	PRSI
od děl i t	PRSI
od děl ova t	PRSI
od děl á v a t	PRSSSI
od dř í t	PRSI
ode dř í t	PRSI
ode hrá t	PRI
ode hrá v a t	PRSSI
ode je t	PRI
ode jí t	PRI
ode pis ova t	PRSI
ode ps a t	PRSI
ode pín a t	PRSI
ode pír a t	PRSI
ode př í t	PRSI
ode rv a t	PRSI
od flák a t	PRSI
od fouk a t	PRSI
od fouk nou t	PRSI
od fouk á v a t	PRSSSI
od frk nou t	PRSI
od frk ova t	PRSI
od frč e t	PRSI
od fuk ova t	PRSI
od hal en í	PRSI
od hal i t	PRSI
od hal ova n ý	PRSSI
od hal ova t	PRSI
od haz ova t	PRSI
od hlas ova t	PRSI
od hlaš ova t	PRSI
od hlás i t	PRSI
od hod i t	PRSI
od houk a t	PRSI
od hrab a t	PRSI
od hrab á v a t	PRSSSI
od hrk a t	PRSI
od hr nou t	PRSI
od ház e t	PRSI
od jist i t	PRSI
od jišť ova t	PRSI
od kap a t	PRSI
od kap ova t	PRSI
od kaz ova t	PRSI
od kašl a t	PRSI
od kašl á v a t	PRSSSI
od klid i t	PRSI
od kliz en í	PRSI
od kliz ova t	PRSI
od klon i t	PRSI
od klop ova t	PRSI
od klopýt a t	PRSI
od kloň ova t	PRSI
od klus a t	PRSI
od klán ě t	PRSI
od kláp ě t	PRSI
od klíz e n í	PRSSI
od klíz e t	PRSI
od klíž i t	PRSI
od koj i t	PRSI
od kolíb a t	PRSI
od komand ova t	PRSI
od kop a t	PRSI
od kop á v a t	PRSSSI
od kouk a t	PRSI
od koup i t	PRSI
od krout i t	PRSI
od krád a t	PRSI
od krý t	PRI
od krý v a t	PRSSI
od kulh a t	PRSI
od kul i t	PRSI
od kup ova t	PRSI
od kutál e t	PRSI
od kvap i t	PRSI
od kvét a t	PRSI
od kých nou t	PRSI
od kýv a t	PRSI
od kýv nou t	PRSI
od lad i t	PRSI
od laď ova t	PRSI
od les n i t	PRSSI
od les ň ova t	PRSSI
od let ě t	PRSI
od lič ova t	PRSI
od liš i t	PRSI
od liš n ý	PRSI
od liš n ě	PRSI
od liš ova t	PRSI
od log ová n í	PRSSS
od lom i t	PRSI
od loud a t	PRSI
od loud i t	PRSI
od loup a t	PRSI
od loup nou t	PRSI
od loup á v a t	PRSSSI
od louč i t	PRSI
od lož i t	PRSI
od lup ova t	PRSI
od luč ova t	PRSI
od lák a t	PRSI
od lám a t	PRSI
od lét a t	PRSI
od lét á v a t	PRSSSI
od lé v a t	PRSSI
od léz t	PRI
od lí t	PRI
od líč i t	PRSI
od mast i t	PRSI
od mlouv a t	PRSI
od mlč e t	PRSI
od moc n i t	PRSSI
od moc ň ova t	PRSSI
od mont ova t	PRSI
od mot a t	PRSI
od mot á v a t	PRSSSI
od moč i t	PRSI
od mršt i t	PRSI
od mršť ova t	PRSI
od myk a t	PRSI
od mysl e t	PRSI
od mysl i t	PRSI
od mýšl e t	PRSI
od měň ova t	PRSI
od měř i t	PRSI
od měř ova t	PRSI
od na uč i t	PPRSI
od na uč ova t	PPRSI
od nos i t	PRSI
od náš e t	PRSI
o dou t	PRI
od pad a t	PRSI
od pad nou t	PRSI
od pad á v a t	PRSSSI
od pal ova t	PRSI
od pař i t	PRSI
od pař ova t	PRSI
od pečet i t	PRSI
od pečeť ova t	PRSI
od pil ova t	PRSI
od pis ova t	PRSI
od plat i t	PRSI
od plav a t	PRSI
od plav i t	PRSI
od plaz i t	PRSI
od pliv nou t	PRSI
od pliv ova t	PRSI
od plomb ova t	PRSI
od ply nou t	PRSI
od plác e t	PRSI
od plíž i t	PRSI
od po moc i	PPRI
od po máh a t	PPRSI
od po rouč e t	PPRSI
od po slouch a t	PPRSI
od po slouch á v a t	PPRSSSI
od pout a t	PRSI
od poušt ě t	PRSI
od po víd aj íc í	PPRSSI
od po věď	PPR
od po zor ova t	PPRSI
od poč i v a dl o	PRSSSSI
od prac ova t	PRSI
od prac ová v a t	PRSSSI
od prav i t	PRSI
od pros i t	PRSI
od proš ova t	PRSI
od prásk nou t	PRSI
od prýsk a t	PRSI
od prýsk nou t	PRSI
od prýsk á v a t	PRSSSI
od pump ova t	PRSI
od pust i t	PRSI
od puz ova t	PRSI
od pušt ěn í	PRSI
od pál i t	PRSI
od pír a t	PRSI
od písk a t	PRSI
od písk nou t	PRSI
od rad i t	PRSI
od raz i t	PRSI
od raz ova t	PRSI
o drb a t	PRSI
o drh nou t	PRSI
od rod i l ec	PRSSI
od rod i t	PRSI
od ruš ova t	PRSI
od ryp ova t	PRSI
od ráž e t	PRSI
od rýp a t	PRSI
od rýp á v a t	PRSSSI
od rý t	PRI
od rý v a t	PRSSI
od růst a t	PRSI
od sek a t	PRSI
od sek á v a t	PRSSSI
od skak ova t	PRSI
od skoč i t	PRSI
od slouž i t	PRSI
od sluh ova t	PRSI
od soud c ova t	PRSSI
od soud i t	PRSI
od souv a c í	PRSSI
od souz en ý	PRSI
od spěch a t	PRSI
od start ova t	PRSI
od stiň ova t	PRSI
od ston a t	PRSI
od stoup i t	PRSI
od stran i t	PRSI
od stran ěn í	PRSI
od straň ova t	PRSI
od straš ova t	PRSI
od strk a t	PRSI
od strk ova t	PRSI
od strk á v a t	PRSSSI
od stroj i t	PRSI
od stroj ova t	PRSI
od stup ň ova t	PRSSI
od stín i t	PRSI
od stěh ova t	PRSI
od střel i t	PRSI
od střel ova t	PRSI
od střík nou t	PRSI
od sun ova t	PRSI
od suz ova t	PRSI
od syp a t	PRSI
od syp á v a t	PRSSSI
od sák nou t	PRSI
od sá t	PRI
od sá v a t	PRSSI
od síř i t	PRSI
od sýp a t	PRSI
od tah a t	PRSI
od tah ova t	PRSI
od tanc ova t	PRSI
od tlač i t	PRSI
od tlouc i	PRI
od tlouk a t	PRSI
od toč i t	PRSI
od trh nou t	PRSI
od trh ova t	PRSI
od tuš i t	PRSI
od táh nou t	PRSI
od téc i	PRI
od ték a t	PRSI
od u mír a t	PPRSI
od u mř í t	PPRSI
od uč i t	PRSI
od val ova t	PRSI
od va nou t	PRSI
od vaz ova t	PRSI
od vař i t	PRSI
od vař ova t	PRSI
od vel e t	PRSI
od vesl ova t	PRSI
od vlh nou t	PRSI
od vléc i	PRI
od vlék a t	PRSI
od vlík a t	PRSI
od vod n i t	PRSSI
od vod ň ova t	PRSSI
od vol á v a t	PRSSSI
od vrac e n í	PRSSI
od vrac e t	PRSI
od vrh nou t	PRSI
od vrh ova t	PRSI
od vrávor a t	PRSI
od vál e t	PRSI
od vá t	PRI
od váz a t	PRSI
od véz t	PRI
od víj e t	PRSI
od větr a t	PRSI
od vš iv i t	PRSSI
od vš iv ova t	PRSSI
od z broj i t	PPRSI
od z broj ova t	PPRSI
od zn í t	PRSI
od zn í v a t	PRSSSI
od z pě v ova t	PPRRSI
od zvon i t	PRSI
od zván ě t	PRSI
o dí t	PRI
o dí v a t	PRSSI
od čar ova t	PRSI
od čep ova t	PRSI
od čerp a t	PRSI
od čerp á v a t	PRSSSI
od čin i t	PRSI
od čiň ova t	PRSI
o dě n ý	PRSI
od řez á v a t	PRSSSI
od řez á v á n í	PRSSSSS
od říc i	PRI
od řík á n í	PRSSS
od řík á v a t	PRSSSI
o dř í t	PRSI
od říz nu t í	PRSSI
od šifr ova t	PRSI
od škod n i t	PRSSI
od škrt nou t	PRSI
od škrt á v a t	PRSSSI
od šněr ova t	PRSI
od šoup nou t	PRSI
od šour a t	PRSI
od šroub ova t	PRSI
od štip ova t	PRSI
od štíp a t	PRSI
od štíp nou t	PRSI
od štíp á v a t	PRSSSI
od štěp i t	PRSI
od šup ova t	PRSI
o fouk nou t	PRSI
o haz ova t	PRSI
oheň	R
o hlad i t	PRSI
o hlaš ova t	PRSI
o hled a t	PRSI
o hluch nou t	PRSI
o hluš i t	PRSI
o hluš ova t	PRSI
o hluš uj íc í	PRSSI
o hlás i t	PRSI
o hláv k a	PRSI
o hlíd a t	PRSI
o hmat a t	PRSI
o hn a t	PPPI
o hobl ova t	PRSI
o hobl ová v a t	PRSSSI
o hod i t	PRSI
o hol i t	PRSI
o hrab a n ý	PRSSI
o hrab a t	PRSI
o hrab ova t	PRSI
o hrad i t	PRSI
o hran ič i t	PRSSI
o hraz ova t	PRSI
o hr nou t	PRSI
o hrom i t	PRSI
o hrom ova t	PRSI
o hroz i t	PRSI
o hrož ova t	PRSI
o hryz a n ý	PRSSI
o hryz a t	PRSI
o hryz ek	PRI
o hryz nou t	PRSI
o hryz ova t	PRSI
o hrá t	PRI
o hrá v a t	PRSSI
o hyzd i t	PRSI
o hán ě t	PRSI
o ház e t	PRSI
o háč k ova t	PRSSI
o hýb a t	PRSI
o hřá t	PRI
o je t	PRI
o jíd a t	PRSI
o jížd ě t	PRSI
o kal i t	PRSI
o kap a t	PRSI
o kartáč ova t	PRSI
ok at ě	RSI
o klep a t	PRSI
o klep nou t	PRSI
o klep á v a t	PRSSSI
o klesť ova t	PRSI
o klešť ova t	PRSI
o klov a t	PRSI
o klát i t	PRSI
ok o	RI
o kol k ova t	PRSSI
o kol n ost	PRSS
o kol n í	PRSI
o kol o	PRS
o kol ík ova t	PRSSI
o kop a t	PRSI
o kop á v a t	PRSSSI
o kor a t	PRSI
o kouk a t	PRSI
o kouk nou t	PRSI
o kouk á v a t	PRSSSI
o kous a t	PRSI
o kous á v a t	PRSSSI
o kouzl i t	PRSI
o kořen i t	PRSI
o kraš l ova t	PRSSI
o krouh a t	PRSI
o krouh á v a t	PRSSSI
o krouž k ova t	PRSSI
o kráj e t	PRSI
o kráš l i t	PRSSI
o kuk ova t	PRSI
o kul at i t	PRSSI
o kys el i t	PRRSI
o křik ova t	PRSI
o lam ova t	PRSI
olej	R
olej ova t	RSI
o liz ova t	PRSI
o loup a t	PRSI
o loup i t	PRSI
o loup á v a t	PRSSSI
o lup ova t	PRSI
o lám a t	PRSI
o lín a t	PRSI
o lít a t	PRSI
o líz a t	PRSI
o líz nou t	PRSI
o mak a t	PRSI
o mak á v a t	PRSSSI
o mal ova t	PRSI
o mam ova t	PRSI
o mast i t	PRSI
o maz a t	PRSI
o mačk a t	PRSI
o mdl í t	PRSI
o mdl í v a t	PRSSSI
o met a t	PRSI
o mez en í	PRSI
o mez en ý	PRSI
o mez ova t	PRSI
o mez uj íc í	PRSSI
o mešk a t	PRSI
o mešk á v a t	PRSSSI
o mil ost n i t	PRSSSI
o mlad i t	PRSI
o mlaz ova t	PRSI
o mlouv a t	PRSI
o mluv n ě	PRSI
o mlád nou t	PRSI
o mlát i t	PRSI
o ml í t	PRSI
o mlž i t	PRSI
o modř i t	PRSI
o mot a t	PRSI
o mot á v a t	PRSSSI
o moč i t	PRSI
o mrk nou t	PRSI
o mrz e t	PRSI
o mám en ý	PRSI
o mám i t	PRSI
o máč e t	PRSI
o míl a t	PRSI
o mý t	PRI
o mý v a t	PRSSI
o pad a t	PRSI
o pad nou t	PRSI
o pad á v a t	PRSSSI
o pal ova t	PRSI
o pancéř ova t	PRSI
o pan ova t	PRSI
o patr n ý	PRSI
o patr ova t	PRSI
o patř en í	PRSI
o patř i t	PRSI
o patř ova t	PRSI
o pař i t	PRSI
o pepř i t	PRSI
o pepř ova t	PRSI
oper ace	RS
oper ova t	RSI
o pevn i t	PRSI
o pil ova t	PRSI
o pis ova t	PRSI
o plak a t	PRSI
o plak á v a t	PRSSSI
o plat i t	PRSI
o plod i t	PRSI
o plot i t	PRSI
o plác e t	PRSI
o plét a t	PRSI
o pot i t	PRSI
o po třeb i t	PPRSI
o po třeb ova t	PPRSI
o po třeb ová v a t	PPRSSSI
o poušt ě t	PRSI
o po vrh nou t	PPRSI
o po víd a t	PPRSI
o pozd i t	PRSI
o požď ova t	PRSI
o prac ová v a t	PRSSSI
o pras i t	PRSI
o prask a t	PRSI
o pr a t	PRSI
o prav d ic k y	PRSSSI
o prav i t	PRSI
o praš ova t	PRSI
o prch a t	PRSI
o prud i t	PRSI
o práš i t	PRSI
o prýsk a t	PRSI
o prýsk nou t	PRSI
o prýsk á v a t	PRSSSI
o prš e t	PRSI
o ps a t	PRSI
o pt a t	PRSI
o pust i t	PRSI
o pál i t	PRSI
o pás a t	PRSI
o péc i	PRI
o pék a t	PRSI
o pík a t	PRSI
o pín a t	PRSI
o pě v a t	PRSSI
o pě v ova t	PRSSI
o raz í tk ova t	PRSRSI
ordin ac e	RSI
ordin ova t	RSI
organiz átor	RS
orient ač n í	RSSI
orient ova t	RSI
o ros i t	PRSI
o roub ova t	PRSI
o rv a t	PRSI
o rám ova t	PRSI
o ráž e t	PRSI
o rýs ova t	PRSI
o rý t	PRI
o sch nou t	PRSI
o sek a t	PRSI
o sek á v a t	PRSSSI
o sidl ova t	PRSI
o slab en í	PRSI
o slab i t	PRSI
o slad i t	PRSI
o slav i t	PRSI
o slav ova t	PRSI
o slaz ova t	PRSI
o slin i t	PRSI
o slun i t	PRSI
o slyš e t	PRSI
o sláb nou t	PRSI
o smaž i t	PRSI
o sol i t	PRSI
o souš e t	PRSI
o soč i t	PRSI
o soč ova t	PRSI
o s prch ova t	PPRSI
o stouz e t	PRSI
o strouh a t	PRSI
o strouh á v a t	PRSSSI
ostr ý	RI
o střel ova t	PRSI
ostř i t	RSI
ostř í	RI
o stříl e t	PRSI
o suš i t	PRSI
o suš ova t	PRSI
o svobod i t	PRSI
o svoboz ova t	PRSI
o svoboz uj íc í	PRSSI
o svíc en ost	PRSS
o svít i t	PRSI
o svěc ova t	PRSI
o taz ova t	PRSI
o test ova t	PRSI
o tes á v a t	PRSSSI
ote vír a t	RRSI
ote vř en ě	RRSI
o tip ova n ý	PRSSI
o tisk nou t	PRSI
o tisk ova t	PRSI
o tlač i t	PRSI
o tlouc i	PRI
o tlouk a t	PRSI
o toč i t	PRSI
o trav a	PRI
o trh a t	PRSI
o trk a t	PRSI
o tr nou t	PRSI
otrok	R
otrok yn ě	RSI
otroč i t	RSI
o tráv i t	PRSI
o tup i t	PRSI
o tup ě t	PRSI
o tuž i t	PRSI
o tuž ova t	PRSI
ot vír a t	RRSI
o táz a t	PRSI
o táz k a	PRSI
o táč e t	PRSI
o téc i	PRI
o ték a t	PRSI
o tír a t	PRSI
o třep a t	PRSI
o třep i t	PRSI
o třás a t	PRSI
o třás t	PRI
o třísk a t	PRSI
o tř í t	PRSI
o va nou t	PRSI
o vaz ova t	PRSI
o vař i t	PRSI
o vař ova t	PRSI
o vdov ě t	PRSI
o vlaž ova t	PRSI
o vlh nou t	PRSI
o vlád a t	PRSI
o vlád nou t	PRSI
o v roub i t	PPRSI
o vál e t	PRSI
o vá t	PRI
o váz a t	PRSI
o ví v a t	PRSSI
o věs i t	PRSI
o věř ova t	PRSI
o věš en ý	PRSI
o věš e t	PRSI
o věš ova t	PRSI
oxid ova t	RSI
o zař ova t	PRSI
o z broj i t	PPRSI
o zdrav i t	PRSI
o zdrav ova t	PRSI
o zelen ě n í	PRSSI
o z kus i t	PPRSI
o zlac ova t	PRSI
o znač i t	PRSI
o znač ova n ý	PRSSI
o znač ova t	PRSI
o znač uj íc í	PRSSI
o zob a t	PRSI
o zoub k ova t	PRSSI
o zv a t	PRSI
o zář i t	PRSI
o zýv a t	PRSI
o čad i t	PRSI
o čaloun i t	PRSI
o čar ova t	PRSI
o čar ová n í	PRSSS
o ček á v a n ě	PRSSSSI
o ček á v a t	PRSSSI
o čern i t	PRSI
o čerň ova t	PRSI
o čes a t	PRSI
o čich a t	PRSI
o čich nou t	PRSI
o čich á v a t	PRSSSI
o čist i t	PRSI
o čisť ova t	PRSI
o čišť ova t	PRSI
oč k o	RSI
oč k ova t	RSSI
o čmuch a t	PRSI
o čmuch á v a t	PRSSSI
o čoud i t	PRSI
o čuch á v a t	PRSSSI
o čum ova t	PRSI
o číh nou t	PRSI
o čísl ova t	PRSI
o čísl ová v a t	PRSSSI
o řez a t	PRSI
o šetř i t	PRSI
o šetř ova c í	PRSSI
o šetř ov n a	PRSSI
o šid i t	PRSI
o škleb ova t	PRSI
oškliv ý	RI
o škrob i t	PRSI
o škvař i t	PRSI
o šlap a t	PRSI
o šoup a t	PRSI
o šplích a t	PRSI
o šplích nou t	PRSI
o štip ova t	PRSI
o štíp a t	PRSI
o štíp nou t	PRSI
o švindl ova t	PRSI
o ší t	PRI
o ťuk a t	PRSI
o ťuk á v a t	PRSSSI
o žeh nou t	PRSI
o žeh ova t	PRSI
o žen i t	PRSI
o žr a t	PRSI
o žvýk a t	PRSI
o žíh a t	PRSI
o žín a t	PRSI
o ží v a t	PRSSI
pach a tel	RSS
pacht ova t	RSI
pad aj íc í	RSSI
pad nou t	RSI
pa děl a t	PRSI
pak	R
pa kůň	PR
pal b a	RSI
pal ič k ova t	RSSSI
pamat ova t	RSI
památ k a	RSI
paměť	R
pancéř ova t	RSI
pan ova t	RSI
pan áč ek	RSI
pan áč k ova t	RSSSI
pan í	RI
parcel ova t	RSI
parfém	R
parfém ova t	RSI
park ova t	RSI
park ov iště	RSR
parod ova t	RSI
parád i t	RSI
patl a t	RSI
patř i t	RSI
patř ič n ě	RSSI
pavouk	R
pavouč ek	RI
pař i t	RSI
paš ova t	RSI
paž e	RI
pejs ek	RI
peníz e	RI
pepř	R
pepř i t	RSI
perl a	RI
perl eť ář sk ý	RSSSI
perl i t	RSI
per o	RI
pes	R
pevn ost	RS
pevn ě	RI
pečet i t	RSI
peč liv ost	RSS
peč ova t	RSI
pilot ova t	RSI
pink a t	RSI
pink nou t	RSI
pipl a t	RSI
pisk l av ě	RSSI
pitom ě t	RSI
pitv a t	RSI
pižl a t	RSI
placht a	RI
placht i t	RSI
plak a t	RSI
pla n ouc í	RSSI
pla nou t	RSI
plat i t	RSI
plat n ý	RSI
plav a t	RSI
plav ec	RI
plav i t	RSI
plav k y	RSI
plaz	R
plaz i t	RSI
plač k y	RSI
plač íc í	RSI
plaš i t	RSI
plen i t	RSI
plesk a t	RSI
plesk a čk a	RSSI
plesk nou t	RSI
plesk á n í	RSSS
plesn iv ý	RSI
plesn iv ě	RSI
plesn iv ě t	RSSI
plev el i t	RRSI
pleš at ě t	RSSI
pliv a t	RSI
pliv nou t	RSI
pln i t	RSI
pln o	RI
pln ý	RI
pln ě	RI
ploch a	RI
plod	R
plod n ý	RSI
plomb ova t	RSI
ply nou t	RSI
plác aj íc í	RSSI
plác a t	RSI
plác nou t	RSI
plán	R
plán ova n ý	RSSI
plán ová n í	RSSS
plát c e	RSI
plát ek	RI
plát ova t	RSI
plés t	RI
plí t	RI
plíž i t	RSI
po baf á v a t	PRSSSI
po bav i t	PRSI
po bli nk a t	PRSSI
po bloud i t	PRSI
po blouzn i t	PRSI
po blázn i t	PRSI
po blí t	PRI
po bod a t	PRSI
po bod nou t	PRSI
po bol í v a t	PRSSSI
po bour a t	PRSI
po bouř i t	PRSI
po boř i t	PRSI
po bož n ý	PRSI
po bratř i t	PRSI
po brouk á v a t	PRSSSI
po bruk ova t	PRSI
po brynd a t	PRSI
po buř ova t	PRSI
po bád a t	PRSI
po bý t	PRI
po bý v a t	PRSSI
poc en í	RSI
po chcíp a t	PRSI
po checht á v a t	PRSSSI
po chleb ova t	PRSI
po chod i t	PPPI
po chop en í	PRSI
po chop i t	PRSI
po chop i teln ý	PRSSI
po chop ova t	PRSI
po chov á v a t	PRSSSI
po chut n a t	PRSSI
po chval a	PRI
po chvál i t	PRSI
po chyb a	PRI
po chyb i t	PRSI
po chyb n ost	PRSS
po chyb ova t	PRSI
po chyb ova č n ě	PRSSSI
po chyc ova t	PRSI
po chyt a t	PRSI
po chyt nou t	PRSI
po chyt á v a t	PRSSSI
po cint a n ý	PRSSI
po cit	PR
po ciť ova t	PRSI
po ct i v ost	RRSSS
po ct i v ý	RRSSI
po ct i v ě	RRSSI
po ct í t	RRSI
po ct í v a t	RRSSSI
po cuch a t	PRSI
po cukr ova t	PRSI
po cvič i t	PRSI
po cák a t	PRSI
po cít i t	PRSI
po dař i t	PRSI
pod barv i t	PRSI
pod cen i t	PRSI
pod chyt i t	PRSI
pod chyt nou t	PRSI
pod dimenz ova t	PRSI
pod dol ova t	PRSI
pode hní v a t	PRSSI
pode jí t	PRI
pode ml í t	PRSI
pode pis ova t	RRSI
pode ps a t	PRSI
pode pír a t	PRSI
pode př í t	PRSI
pode t nou t	PPPI
pode zd í t	PRSI
pod fouk nou t	PRSI
pod hod i t	PRSI
pod hrab a t	PRSI
pod hrab á v a t	PRSSSI
pod hr nou t	PRSI
pod je t	PRI
pod jížd ěj íc í	PRRSI
pod jížd ě t	PRSI
pod kas a t	PRSI
pod klouz nou t	PRSI
pod klouz á v a t	PRSSSI
pod kluz ova t	PRSI
pod kop a t	PRSI
pod kop á v a t	PRSSSI
pod kuř ova t	PRSI
pod lam ova t	PRSI
pod let ě t	PRSI
pod li t in a	PRSSI
pod lož i t	PRSI
pod lé v a t	PRSSI
pod léz a t	PRSI
pod léz t	PRI
pod lí t	PRI
pod lí v a t	PRSSI
pod mal ová v a t	PRSSSI
pod mast i t	PRSI
pod maz a t	PRSI
pod maz á v a t	PRSSSI
pod mrač i t	PRSI
pod mín i t	PRSI
pod mín ěn ý	PRSI
pod nik	PR
pod nik aj íc í	PRRSI
pod nik a t	PRSI
pod nik a tel sk ý	PRSSSI
pod nik nou t	PRSI
pod něc ova t	RRSI
po doj i t	PRSI
po do tk nou t	PPRSI
pod pich ova t	PRSI
pod pis ova t	PRSI
pod plav a t	PRSI
pod pál i t	PRSI
pod pích nou t	PRSI
pod raz i t	PRSI
po draž i t	PRSI
po drb a t	PRSI
pod rob n ost	PRSS
pod rob ova t	PRSI
po dráp a t	PRSI
po drážd i t	PRSI
po drážd ěn í	PRSI
po drážd ěn ě	PRSI
pod ráž e t	PRSI
pod rý t	PRI
pod rý v a t	PRSSI
pod růst a t	PRSI
po drž e t	PRSI
pod strk ova t	PRSI
pod stroj i t	PRSI
pod stroj ova t	PRSI
pod strč i t	PRSI
pod sun ova t	PRSI
pod syp a t	PRSI
pod syp á v a t	PRSSSI
pod sýp a t	PRSI
pod trh nou t	PRSI
pod trh nu t ý	PRSSI
pod trh ova t	PRSI
pod trh á v a t	PRSSSI
pod tunel ova t	PRSI
pod téc i	PRI
po dup a t	PRSI
po dup nou t	PRSI
po dup ova t	PRSI
po dup á v a t	PRSSSI
pod vaz ova t	PRSI
pod vol ova t	PRSI
pod voz ek	PRI
pod vrac e t	PRSI
pod vrh nou t	PRSI
pod vrh ova t	PRSI
pod vrt nou t	PRSI
pod vrt á v a t	PRSSSI
pod vrát i t	PRSI
pod váz a t	PRSI
pod zim	PR
pod zim ek	PRI
pod zim n í	PRSI
po díl e t	PRSI
po dí t	PRI
po dív a n á	PRSSI
po dív a t	PRSI
po děd i t	PRSI
po děk ova t	PRSI
po děl a t	PRSI
po děl ova t	PRSI
po děs i t	PRSI
pod řad n ý	PRSI
pod řaz ova t	PRSI
pod řek nou t	PRSI
pod řiz ova t	PRSI
pod říc i	PRI
pod říd i t	PRSI
po dřím nou t	PRSI
po dř í t	PRSI
pod říz nou t	PRSI
pod škrt nou t	PRSI
pod ší t	PRI
pod ší v a t	PRSSI
po fouk a t	PRSI
po frk á v a t	PRSSSI
po fuk ova t	PRSI
po fňuk á v a t	PRSSSI
po gum ova t	PRSI
po han ě n ý	PRSSI
po has nou t	PRSI
po has ín a t	PRSSI
po haz ova t	PRSI
po hek á v a t	PRSSSI
po hlad i t	PRSI
po hlav n ost	PRSS
po hlav í	PRS
po hled	PR
po hled a t	PRSI
po hled n ý	PRSI
po hled á v a t	PRSSSI
po hled ě t	PRSI
po hlin ík ova t	PRSSI
po hlt i t	PRSI
po hléd nou t	PRSI
po hlíd a t	PRSI
po hlíž e t	PRSI
po hn a t	PRSI
po hnoj i t	PRSI
po hněv a t	PRSI
po hod i t	PRSI
po hon i t	PRSI
po hop k á v a t	PRRSSSI
po hops á v a t	PRSSSI
po host i t	PRSI
po houp a t	PRSI
po hovoř i t	PRSI
po hrab a t	PRSI
po hrab ova t	PRSI
po hrab á v a t	PRSSSI
po hrd a t	PRSI
po hrd nou t	PRSI
po hroz i t	PRSI
po hryz a t	PRSI
po hryz nou t	PRSI
po hryz á v a t	PRSSSI
po hrá t	PRI
po hyb ova t	PRSI
po hád k a	PRSI
po hán ě t	PRSI
po ház e t	PRSI
po hřeb n í	PRSI
po hřeš i t	PRSI
po hřeš ova t	PRSI
point ova t	RSI
po jedn a t	PRSI
po jedn á n í	PRSSS
po jedn á v aj íc í	PRSSSSI
po j e t í	PRSSS
po jezd i t	PRSI
po jišt ěn í	PRSI
po jišť ova t	PRSI
po jmen ova t	PRSI
po jím a t	PRSI
po jím á n í	PRSSS
po jí t	PRI
po kap a t	PRSI
po kap á v a t	PRSSSI
po kaz i t	PRSI
po kec a t	PRSI
po klad n í	PRSS
po klep nou t	PRSI
po klep á v a t	PRSSSI
po kles	PR
po kles a t	PRSI
po kles á v a t	PRSSSI
po klon i t	PRSI
po klon k ova t	PRSSI
po klop i t	PRSI
po klus á v a t	PRSSSI
po klás t	PRI
po koléb a t	PRSI
po kolíb a t	PRSI
po kos i t	PRSI
po kous a t	PRSI
po koř i t	PRSI
po koř ova t	PRSI
po kož k a	PRSI
po krop i t	PRSI
po kruc ova t	PRSI
po kráj e t	PRSI
po krý t	PRI
po krč i t	PRSI
po kuk ova t	PRSI
po kulh á v a t	PRSSSI
po kác e t	PRSI
po kál e t	PRSI
po kár a t	PRSI
po kýv a t	PRSI
po kýv nou t	PRSI
po křik ova t	PRSI
po křiv i t	PRSI
po křiv ova t	PRSI
po lap i t	PRSI
pol ar iz ova t	RSSSI
po lask a t	PRSI
po lecht a t	PRSI
po lecht á v a t	PRSSSI
po lek a t	PRSI
po lept a t	PRSI
po lept á v a t	PRSSSI
po let ova t	PRSI
po lichot i t	PRSI
po lit ova t	PRSI
po li t í	PRSI
polk nou t	RSI
pol ovin a	RSI
pol ovič n í	RSSI
po lož k a	PRSI
po lám an ý	PRSI
po lám a t	PRSI
po lé v a t	PRSSI
po lí t	PRI
po mal ova t	PRSI
po mast i t	PRSI
po mat en ý	PRSI
po maz a t	PRSI
po mazl i t	PRSI
po maz á v a t	PRSSSI
po mačk a t	PRSI
po maďar št i t	PRSSI
po mil ova t	PRSI
po mlask ova t	PRSI
po mlouv a t	PRSI
po mluv i t	PRSI
po mlát i t	PRSI
po modl i t	PRSI
po modř i t	PRSI
po moč i t	PRSI
po mrk ova t	PRSI
po mrk á v a t	PRSSSI
po mrz nou t	PRSI
po mst í t	PRSI
po muchl a t	PRSI
po mysl e t	PRSI
po mysl i t	PRSI
po máh a t	PRSI
po más t	PRI
po mích a t	PRSI
po mýl i t	PRSI
po mýšl e t	PRSI
po měd i t	PRSI
po měr n ý	PRSI
po měr n ě	PRSI
po na uč i t	PPRSI
po nech a t	PRSI
po nech á v a t	PRSSSI
po nič i t	PRSI
po niž ova t	PRSI
po noc ova t	PRSI
po noř en í	PRSI
po noř ova t	PRSI
po níž en í	PRSI
po níž i t	PRSI
po ob naž i t	PPRSI
po ob rát i t	PPRSI
po ode jí t	PPRI
po od hal i t	PPRSI
po od hr nou t	PPRSI
po od je t	PPRI
po od lož i t	PPRSI
po od stoup i t	PPRSI
po o prav i t	PPRSI
po ote vír a t	PRRSI
po ote vř í t	PRRSI
popel av ě t	RSSI
popel i t	RSI
po pich ova t	PRSI
po pis	PR
po pis ova t	PRSI
po plach	PR
po plac ova t	PRSI
po plak a t	PRSI
po plat ek	PRI
po plat i t	PRSI
po plaš i t	PRSI
po plen i t	PRSI
po plesk a t	PRSI
po pliv a t	PRSI
po plác a t	PRSI
po plác á v a t	PRSSSI
po plés t	PRI
po po hn a t	PPRSI
po po jí t	PPRI
po po léz t	PPRI
po po nés t	PPRI
po po strk á v a t	PPRSSSI
po po tah ova t	PPRSI
po pouz e t	PRSI
po poušt ě t	PRSI
po po véz t	PPRI
po po víd a t	PPRSI
po po šoup nou t	PPRSI
po prask a t	PRSI
po prask ova t	PRSI
po prask á v a t	PRSSSI
po pr a t	PRSI
po prav ova t	PRSI
po praš ova t	PRSI
po prch á v a t	PRSSSI
po pros i t	PRSI
po prsk a t	PRSI
po práš i t	PRSI
po práš k ova t	PRSSI
po ps a t	PRSI
po pt a t	PRSI
po pt á v a t	PRSSSI
po pud i t	PRSI
po puk a t	PRSI
popular iz ova n ý	RSSSI
po pust i t	PRSI
po puz ova t	PRSI
po pál i t	PRSI
po pás t	PRI
po pích a t	PRSI
po pích nou t	PRSI
po pín a t	PRSI
po pír a t	PRSI
po pě v ova t	PRSSI
po přá t	PRI
po př í t	PRSI
po rad a	PRI
po rad c e	PRSI
po rad n a	PRSI
po ran i t	PRSI
po ran ěn í	PRSI
po ran ěn ý	PRSI
po raz i t	PRSI
po rob i t	PRSI
po rod i t	PRSI
po ros i t	PRSI
po rouč e t	PRSI
po roz um ě n í	PPRSSI
po rub a t	PRSI
po ruč i t	PRSI
po ruč ník ova t	PRSSI
po ruš i t	PRSI
po ruš i teln ý	PRSSI
po ruš ova t	PRSI
po rv a t	PRSI
po ráž e t	PRSI
po rýp a t	PRSI
po s chov á v a t	PPRSSSI
po sed ě t	PRSI
po sek a t	PRSI
po sek nou t	PRSI
po sek á v a t	PRSSSI
po ser out k a	PRRSI
po se čk a t	PPRSI
po se čk á n í	PPRSSS
po sil ova t	PRSI
po skak ova t	PRSI
po skoč i t	PRSI
po skvrn i t	PRSI
po skvrň ova t	PRSI
po skyt nou t	PRSI
po skyt ova t	PRSI
po sl a n ec	PRSSI
po sled n í	PRSI
po slin i t	PRSI
po slouch a t	PRSI
po slouž i t	PRSI
po sluch ač	PRS
po sluh ova t	PRSI
po sluš n ě	PRSI
po smut n ě t	PRSSI
po smí v a t	PRSSI
po s níd a t	PPRSI
po sol i t	PRSI
po souz en í	PRSI
po s prav i t	PPRSI
po srk á v a t	PRSSSI
po s tah ova t	PPRSI
po sta v en ý	PRSSI
po stač i t	PRSI
po stač ova t	PRSI
po stač uj íc í	PRSSI
po stih nou t	PRSI
po stih ova t	PRSI
po stih uj íc í	PRSSI
po ston á v a t	PRSSSI
po stoup i t	PRSI
po straš i t	PRSI
po strk ova t	PRSI
po strk á v a t	PRSSSI
po stroj i t	PRSI
po stroj ova t	PRSI
po struh ova t	PRSI
po strč i t	PRSI
po stup ova t	PRSI
po stá t	PRI
po stýsk a t	PRSI
po střik ova t	PRSI
po střík a t	PRSI
po střík nou t	PRSI
po střík á v a t	PRSSSI
po stříl e t	PRSI
po suz ova t	PRSI
po svít i t	PRSI
po svěc ova t	PRSI
po svět i t	PRSI
po syp a t	PRSI
po syp á v a t	PRSSSI
po síl a t	PRSI
po síl i t	PRSI
po sýp a t	PRSI
pot	R
po tah ova t	PRSI
po tem n ě t	PRSSI
potenc iál	RS
po tisk nou t	PRSI
pot i t	RSI
po tlač i t	PRSI
po tlač ova t	PRSI
po tlouc i	PRI
po tlouk a t	PRSI
po trav in a	PRSI
po tref en ý	PRSI
po trest a t	PRSI
po trh a t	PRSI
po trh nou t	PRSI
po trh ova t	PRSI
po trh á v a t	PRSSSI
po trp ě t	PRSI
po trv a t	PRSI
po tráp i t	PRSI
po tuch nou t	PRSI
po tul ova t	PRSI
po tup i t	PRSI
po tvoř i t	PRSI
po tvrd i t	PRSI
po tvrz en í	PRSI
po tvrz ova t	PRSI
po tvrz ová n í	PRSSS
po táh nou t	PRSI
po táz a t	PRSI
po týr a t	PRSI
po těš en í	PRSI
po těš en ý	PRSI
po těš i t	PRSI
po těš ova t	PRSI
po třeb n ý	PRSI
po třeb ova t	PRSI
po třep a t	PRSI
po třep á v a t	PRSSSI
po třešt i t	PRSI
po třás a t	PRSI
po třísk a t	PRSI
po tř í t	PRSI
po u kaz ova t	PPRSI
po u káz a t	PPRSI
po ulič ní	PRS
pout a t	RSI
pout ník	RS
pout o	RI
po uč i t	PRSI
po uč n ě	PRSI
po uč ova t	PRSI
poušt ě t	RSI
poušť	R
po u ží v a t	PPRSSI
po vad i t	PRSI
po vad nou t	PRSI
po val eč ův	PRSI
po val i t	PRSI
po vař i t	PRSI
po vesel i t	PRSI
po večeř e t	PRSI
po vléc i	PRI
po vlék a t	PRSI
po vlík a t	PRSI
po vod eň	PRI
po vol an ý	PRSI
po vol a t	PRSI
po vol en í	PRSI
po vol ova t	PRSI
po vol á n í	PRSSS
po vol á v a t	PRSSSI
po voz i t	PRSI
po vrch	PR
po vrh nou t	PRSI
po v sta t	PPRI
po v stá v a t	PPRSSI
po vy léz t	PPRI
po vy ráž e t	PPRSI
po vy skak ova t	PPRSI
po vy skoč i t	PPRSI
po vyš ova t	PRSI
po vz bud i t	PPRSI
po vz buz en í	PPRSI
po vz buz ova t	PPRSI
po vz dych a t	PPRSI
po vz dych á v a t	PPRSSSI
po vz náš e t	PPRSI
po vz nés t	PPRI
po vál e t	PRSI
po vápn i t	PRSI
po vá t	PRI
po váz a t	PRSI
po víd a t	PRSI
po ví t	PRI
po věd ě t	PRSI
po věr a	PRI
po věs i t	PRSI
po větř í	PRS
po věř i t	PRSI
po věř ova t	PRSI
po všim nou t	PRSI
po za myk a t	PPRSI
po za sta v i t	PPRSSI
po za týk a t	PPRSI
po z bý t	PPRI
po z bý v a t	PPRSSI
pozd i t	RSI
pozd n í	RSI
po zdrav	PR
po zdrav ova t	PRSI
po z drž e t	PPRSI
po z drž ova t	PPRSI
po zdvih a t	PRSI
po zdvih nou t	PRSI
po zdvih ova t	PRSI
pozd ě	RI
po ze pt a t	PPRSI
po z has ín a t	PPRSSI
po zlac ova t	PRSI
po zlat i t	PRSI
po z měň ova t	PPRSI
po znam en a t	PRSSI
po znam en á v a t	PRSSSSI
po znač i t	PRSI
po znám k a	PRSI
po zor	PR
po zor ova t	PRSI
po z pě v ova t	PPRRSI
po z trác e t	PPRSI
po zv a t	PRSI
po zv á n í	PRSSS
po zů stá v a t	PPRSSI
po čern i t	PRSI
po čest n ý	RRSI
po čist i t	PRSI
po čišť ova t	PRSI
po čk a t	PRSI
po čmár a t	PRSI
po čur a t	PRSI
po čár a t	PRSI
po číh a t	PRSI
po ďob a t	PRSI
po řez a t	PRSI
po řiz ova t	PRSI
po řád ek	PRI
po řád n ý	PRSI
po řád n ě	PRSI
po říd i t	PRSI
po šept á v a t	PRSSSI
po šin ova t	PRSI
po škleb ova t	PRSI
po škoz en ý	PRSI
po škoz ova t	PRSI
po škrob i t	PRSI
po škub a t	PRSI
po škub nou t	PRSI
po škub ova t	PRSI
po škub á v a t	PRSSSI
po šoup nou t	PRSI
po špin i t	PRSI
po šplouch a t	PRSI
po šplích a t	PRSI
po štv a t	PRSI
po štíp a t	PRSI
po švih ova t	PRSI
po ší v a t	PRSSI
po šťouch nou t	PRSI
po šťour a t	PRSI
po ťap a t	PRSI
po žad ova t	PRSI
po žal ova t	PRSI
po žehn a n ý	PRSSI
po žehn a t	PRSI
po žeh nou t	PRSI
po žehn á n í	PRSSS
po žehn á v a t	PRSSSI
po žeh ova t	PRSI
po žád á n í	PRSSS
po žín a t	PRSI
po ží v a t	PRSSI
prach	R
prach y	RI
prac ova t	RSI
prac ov ník	RSS
prac ová n í	RSSS
prac uj íc í	RRSI
pr a dl en a	RSSSI
pra děd ek	PRI
pra děd eček	PRS
pra les	PR
pramen i t	RSI
pra mál o	PRI
pr a n í	RSSI
pras e	RI
pras i t	RSI
prask a t	RSI
prask nou t	RSI
prask ot	RS
prav d a	RRI
prav i dl o	RSSI
prav i t	RSI
prav ý	RI
pra věk ý	PRI
praš ník ov ý	RSSI
praž i t	RSI
prch a t	RSI
prch a v ý	RSSI
prch nou t	RSI
prd nou t	RSI
prepar ova t	RSI
privat iz ac e	RSSI
privat iz ova t	RSSI
pro bd í t	PRSI
problem at ik a	RSSI
problem at ič n ost	RSSSS
pro blesk nou t	PRSI
pro blesk ova t	PRSI
pro blesk á v a t	PRSSSI
problém	R
problém ov ý	RSI
pro blýsk a t	PRSI
pro blýsk nou t	PRSI
pro bod a t	PRSI
pro bod nou t	PRSI
pro bod á v a t	PRSSSI
pro boj ova t	PRSI
pro boj ová v a t	PRSSSI
pro bouz e t	PRSI
pro boř i t	PRSI
pro bud i t	PRSI
pro bíh a t	PRSI
pro běh nou t	PRSI
pro běl i t	PRSI
pro běl á v a t	PRSSSI
pro ced i t	PRSI
proces	R
pro cez ova t	PRSI
pro chlad nou t	PRSI
pro chlast a t	PRSI
pro chod i t	PPPI
pro choz en ý	PRSI
pro chví v a t	PRSSI
pro chvě t	PRI
pro cház e t	PPPI
pro cház k a	PPPI
pro cl í t	PRSI
pro cour a t	PRSI
pro cvak a t	PRSI
pro cvak nou t	PRSI
pro cvak á v a t	PRSSSI
pro cvič i t	PRSI
pro cvič ova t	PRSI
pro cít i t	PRSI
pro dlouž en á	PRSI
pro dlouž en ý	PRSI
pro dlouž i t	PRSI
pro dluž ova t	PRSI
pro duk c e	PRSI
pro duk ova t	PRSI
pro duk č n í	PRSSI
pro děl á v a t	PRSSSI
pro děr av ě t	PRSSI
pro dř í t	PRSI
profil ova t	RSI
pro filtr ova t	PRSI
pro financ ová v á n í	PRSSSSS
pro flák a t	PRSI
pro flák nou t	PRSI
pro fouk a t	PRSI
pro fouk nou t	PRSI
pro fouk á v a t	PRSSSI
pro fuk ova t	PRSI
pro gram	PR
pro haz ova t	PRSI
pro hlaš ova t	PRSI
pro hled a t	PRSI
pro hlub ova t	PRSI
pro hlás i t	PRSI
pro hláš en ý	PRSI
pro hléd a t	PRSI
pro hléd nou t	PRSI
pro hlíd a t	PRSI
pro hlíd k a	PRSI
pro hmat á v a t	PRSSSI
pro hmát nou t	PRSI
pro hní t	PRI
pro hní v a t	PRSSI
pro hod i t	PRSI
pro hospod ař i t	PRSSI
pro hrab ova t	PRSI
pro hrab á v a t	PRSSSI
pro hryz a t	PRSI
pro hryz nou t	PRSI
pro hád a t	PRSI
pro hán ě t	PRSI
pro ház e t	PRSI
pro hýb a t	PRSI
pro hřeš i t	PRSI
pro hřeš ova t	PRSI
pro hřá t	PRI
pro jedn a t	PRSI
pro jedn á v a t	PRSSSI
pro jekt	PR
pro jekt ant	PRS
pro jekt ova t	PRSI
pro je t	PRI
pro jev i t	PRSI
pro jev ova t	PRSI
pro jezd i t	PRSI
pro jíd a t	PRSI
pro jím a t	PRSI
pro jí t	PRI
pro jížd ě t	PRSI
pro kaz a teln ě	PRSSI
pro kaz ova t	PRSI
pro klep a t	PRSI
pro klest i t	PRSI
pro klesť ova t	PRSI
pro klešť ova t	PRSI
pro klouz nou t	PRSI
pro klov a t	PRSI
pro klub a t	PRSI
pro kluz ova t	PRSI
pro klád a t	PRSI
pro klí t	PRI
pro kmit nou t	PRSI
pro kop a t	PRSI
pro kop nou t	PRSI
pro kop á v a t	PRSSSI
pro kouk nou t	PRSI
pro kous a t	PRSI
pro kous nou t	PRSI
pro kous á v a t	PRSSSI
pro kouř i t	PRSI
pro krm i t	PRSI
pro kus ova t	PRSI
pro kvét a t	PRSI
pro káz a t	PRSI
pro křeh nou t	PRSI
pro křeh nu t í	PRSSI
pro křič e t	PRSI
pro len oš i t	PRSSI
pro let ě t	PRSI
pro lis ova t	PRSI
pro list ova t	PRSI
pro lom i t	PRSI
pro lož i t	PRSI
pro lám a t	PRSI
pro lé v a t	PRSSI
pro léz a t	PRSI
pro léz t	PRI
pro lín a t	PRSI
pro lí t	PRI
pro lít a t	PRSI
pro lít nou t	PRSI
pro lí v a t	PRSSI
pro mast i t	PRSI
pro mas ír ova t	PRSSI
pro maz a t	PRSI
pro mačk a t	PRSI
pro mačk á v a t	PRSSSI
pro mař i t	PRSI
pro mešk a t	PRSI
pro mlouv a t	PRSI
pro mls a t	PRSI
pro mluv i t	PRSI
pro mlč e t	PRSI
pro mlč ova t	PRSI
pro modr a t	PRSI
pro mok nou t	PRSI
pro moč en ý	PRSI
pro moč i t	PRSI
pro mrh a t	PRSI
pro mysl e t	PRSI
pro máz nou t	PRSI
pro máč e t	PRSI
pro mích a t	PRSI
pro míj e t	PRSI
pro mý t	PRI
pro mýt i t	PRSI
pro mý v a t	PRSSI
pro měn a	PRI
pro měn i t	PRSI
pro měň ova t	PRSI
pro měř i t	PRSI
pro na jím a t	PPRSI
pro na jím a teln ý	PPRSSI
pro ná sled ova t	PPRSI
pro nés t	PRI
pro pacht ova t	PRSI
pro pad a t	PRSI
pro pad l o	PRSI
pro pad nou t	PRSI
pro pad á v a t	PRSSSI
pro pal ova t	PRSI
pro pař i t	PRSI
pro paš ova t	PRSI
pro pich ova t	PRSI
pro pil ova t	PRSI
pro pis ova t	PRSI
pro plat i t	PRSI
pro plav a t	PRSI
pro plav i t	PRSI
pro plác e t	PRSI
pro plét á v a t	PRSSSI
pro plíž i t	PRSI
pro plýtv a t	PRSI
pro pot i t	PRSI
pro poušt ě n í	PRSSI
pro poušt ě t	PRSI
pro po víd a t	PPRSI
pro prac ova t	PRSI
pro prac ová v a t	PRSSSI
pro ps a t	PRSI
pro puk a t	PRSI
pro puk nou t	PRSI
pro pust i t	PRSI
pro pál i t	PRSI
pro péc i	PRI
pro pích a t	PRSI
pro pích nou t	PRSI
pro pích á v a t	PRSSSI
pro pír a t	PRSI
pro pěst ova t	PRSI
pro půjč ova t	PRSI
pro raz i t	PRSI
pro rv a t	PRSI
pro ráž e t	PRSI
pro rý t	PRI
pro rý v a t	PRSSI
pro růst a t	PRSI
pro sak ova t	PRSI
pro sch nou t	PRSI
pro sed ě t	PRSI
pro sek a t	PRSI
pro sek nou t	PRSI
pro sek á v a t	PRSSSI
pros i t	RSI
pro skak ova t	PRSI
pro skoč i t	PRSI
pro slav i t	PRSI
pro slech nou t	PRSI
pro sl ov	PRS
pro slun i t	PRSI
pro slíd i t	PRSI
pro sn í t	PRSI
pro sol i t	PRSI
pro soud i t	PRSI
pro spekul ova t	PRSI
pro ston a t	PRSI
pro strk a t	PRSI
pro strk ova t	PRSI
pro strk á v a t	PRSSSI
pro strč i t	PRSI
pro stud ova t	PRSI
pro stud ová n í	PRSSS
pro styd nou t	PRSI
pro stěh ova t	PRSI
pro střed ek	PRI
pro střed k ova t	PRSSI
pro střed í	PRS
pro střel i t	PRSI
pro střel ova t	PRSI
pro střih á v a t	PRSSSI
pro střík nou t	PRSI
pro stříl e t	PRSI
pro svít i t	PRSI
pro syp a t	PRSI
pro syp á v a t	PRSSSI
pro sák nou t	PRSI
pro síř i t	PRSI
pro sýp a t	PRSI
pro tah ova t	PRSI
pro tanc ova t	PRSI
pro tisk nou t	PRSI
pro tlach a t	PRSI
pro tlač i t	PRSI
pro tlač ova t	PRSI
pro tlouc i	PRI
pro tlouk a t	PRSI
pro t nou t	PPPI
pro toč i t	PRSI
pro trp ě t	PRSI
pro táh nou t	PRSI
pro táč e t	PRSI
pro téc i	PRI
pro třás t	PRI
pro tř í t	PRSI
prout k ař i t	RSSSI
prouž ek	RI
prouž k ova t	RSSI
pro val ova t	PRSI
pro va nou t	PRSI
pro vin i t	PRSI
pro vlh nou t	PRSI
pro vlh č i t	PRSSI
pro vléc i	PRI
pro vlék a t	PRSI
pro vlík a t	PRSI
pro vok ova t	PRSI
pro vol a t	PRSI
pro vol á v a t	PRSSSI
pro von ě t	PRSI
pro voň ova t	PRSI
pro vrt a t	PRSI
pro vrt á v a t	PRSSSI
pro vz dych a t	PPRSI
pro vál e t	PRSI
pro váž e t	PRSI
pro ví v a t	PRSSI
pro větr a t	PRSI
pro věř i t	PRSI
pro zař ova t	PRSI
pro z kouš e t	PPRSI
pro z pyt ova t	PPRSI
pro z pě v ova t	PPRSSI
pro z rad i t	PPRSI
pro z raz ova t	PPRSI
pro zář i t	PRSI
pro zív a t	PRSI
pro čechr a t	PRSI
pro čechr á v a t	PRSSSI
pro ček a t	PRSI
pro čes a t	PRSI
pro čist i t	PRSI
pro čišť ova t	PRSI
pro řek nou t	PRSI
pro řez a t	PRSI
pro řez á v a t	PRSSSI
pro říc i	PRI
pro říd nou t	PRSI
pro šed iv ě t	PRSSI
pro šlap a t	PRSI
pro šlap á v a t	PRSSSI
pro šleh nou t	PRSI
pro šláp nou t	PRSI
pro šoup a t	PRSI
pro špik ova t	PRSI
pro štíp a t	PRSI
pro štíp nou t	PRSI
pro ší t	PRI
pro ší v a t	PRSSI
pro šťouch a t	PRSI
pro šťouch nou t	PRSI
pro ťuk a t	PRSI
pro žr a t	PRSI
pro žvan i t	PRSI
pro žír a t	PRSI
pro ží v a t	PRSSI
prs	R
prsk a t	RSI
prsk nou t	RSI
prst	R
prst en	RS
pruh	R
pruh ova t	RSI
pruž i t	RSI
pruž n ost	RSS
pr á del n í	RSSSI
pr á dl o	RSSI
prásk a t	RSI
prásk nou t	RSI
pr á t	RSI
práv n ic tv í	RSSSS
práv n í	RSI
práv n ík	RSS
prázdn iny	RS
prázdn ot a	RSI
prázdn ý	RI
práš i t	RSI
práš k ova t	RSSI
prýsk nou t	RSI
prš e t	RSI
prů hled n ý	RRSI
ps a c í	RSSI
ps in a	RSI
ps isk o	RRI
ps á t	RSI
ps í	RS
ps íčk ův	RSI
pt á t	RSI
pud	R
pud i t	RSI
pudr ova t	RSI
puk a t	RSI
puk nou t	RSI
pump ova t	RSI
pust i t	RSI
pust nou t	RSI
pust oš i t	RSSI
put ova t	RSI
puz en í	RSI
puč e t	RSI
pytel	R
pytl ač i t	RSSI
pytl ova t	RSI
pytl ík ova t	RSSI
pyš n i t	RSSI
pyš n ý	RSI
pyš n ě	RSI
pách nou t	RSI
pál i t	RSI
pán	R
pár a t	RSI
pár ek	RI
pár k ova t	RSSI
pár ova t	RSI
pás a t	RSI
pás t	RI
pátr a t	RSI
pátr á n í	RSSS
páč i t	RSI
péc i	RI
pér o	RI
pér ova t	RSI
pích nut ý	RRI
píp a t	RSI
píp nou t	RSI
pí seň	RS
písk a t	RSI
písk nou t	RSI
písk ová n í	RSSS
pých a t	RSI
pěch ova t	RSI
pěn i t	RSI
pěst i t	RSI
pěst ova t	RSI
pře bal i t	PRSI
pře barv i t	PRSI
pře bol e t	PRSI
pře brod i t	PRSI
pře bruš ova t	PRSI
pře bud ova t	PRSI
pře bud ová v a t	PRSSSI
pře básn i t	PRSI
pře básn ěn ý	PRSI
pře bíl i t	PRSI
pře bý t	PRI
pře bý v a t	PRSSI
pře ceň ova t	PRSI
pře chlad i t	PRSI
pře chlaz ova t	PRSI
pře chod i t	PPPI
pře chov á v a t	PRSSSI
pře chvál i t	PRSI
pře chyl ova t	PRSI
pře cház e t	PPPI
pře cp a t	PRSI
pře cp á v a t	PRSSSI
před chůd c e	PPPI
přede hrá t	PRI
přede hřá t	PRI
přede hřá t ý	PRSI
přede je t	PRI
přede jí t	PRI
přede ps a t	RSSI
před form ova n ý	PRSSI
před haz ova t	PRSI
před hod i t	PRSI
před hon i t	PRSI
před hán ě t	PRSI
před hří v a t	PRSSI
před je t	PRI
před jížd ě t	PRSI
před klon i t	PRSI
před let ě t	PRSI
pře dluž i t	PRSI
pře dlážd i t	PRSI
před nož i t	PRSI
před náš k a	PRSI
před nés t	PRI
před pis ova t	PRSI
před plat i t	PRSI
před plác e t	PRSI
před po klád a t	PPRSI
před po víd a t	PPRSI
pře draž i t	PRSI
pře draž ova t	PRSI
pře drážd i t	PRSI
pře drž e t	PRSI
pře drž ova t	PRSI
před stih nou t	PRSI
před stih ova t	PRSI
před sun ova t	PRSI
před tanc ova t	PRSI
před tanč i t	PRSI
před tisk nou t	PRSI
před tisk ova t	PRSI
před urč i t	PRSI
před vař i t	PRSI
před vař ova t	PRSI
před vol b a	PRSI
před vol á v a t	PRSSSI
před váleč n ý	PRSI
před víd a t	PRSI
před znam en a t	PRSSI
před znam en á v a t	PRSSSSI
před z pě v ova t	PPRSSI
pře děl a t	PRSI
pře děl i t	PRSI
pře děl ova t	PRSI
pře děl á v a t	PRSSSI
pře děl á v á n í	PRSSSSS
před řík a t	PRSI
před řík á v a t	PRSSSI
pře dř í t	PRSI
pře form ova t	PRSI
pře frč e t	PRSI
pře haz ova t	PRSI
pře hlas ova t	PRSI
pře hlaš ova t	PRSI
pře hlás i t	PRSI
pře hlíd a t	PRSI
pře hnoj i t	PRSI
pře hod i t	PRSI
pře hop k a t	PRRSI
pře hop k ova t	PRRSI
pře hrab a t	PRSI
pře hrab ova t	PRSI
pře hrab á v a t	PRSSSI
pře hrad i t	PRSI
pře hraz ova t	PRSI
pře hr nou t	PRSI
pře hryz a t	PRSI
pře hryz nou t	PRSI
pře hryz á v a t	PRSSSI
pře hráb nou t	PRSI
pře hrá t	PRI
pře hrá v a t	PRSSI
pře hust i t	PRSI
pře hán ě t	PRSI
pře ház e t	PRSI
pře hýb a t	PRSI
pře hřá t	PRI
pře hří v a t	PRSSI
pře je t	PRI
pře jmen ova t	PRSI
pře jíd a t	PRSI
pře jím a t	PRSI
pře jížd ě t	PRSI
pře kap ova t	PRSI
pře kaz i t	PRSI
pře kaz ova t	PRSI
pře klep nou t	PRSI
pře klon i t	PRSI
pře klop i t	PRSI
pře klán ě t	PRSI
pře kláp ě t	PRSI
pře kol k ova t	PRSSI
pře kon a t	PRSI
pře kon stru ova t	PRRSI
pře kontrol ova t	PRSI
pře kon á v a t	PRSSSI
pře kop a t	PRSI
pře kop nou t	PRSI
pře kop á v a t	PRSSSI
pře kous a t	PRSI
pře kous nou t	PRSI
pře kraj ova t	PRSI
pře krač ova t	PRSI
pře krm i t	PRSI
pře kroj i t	PRSI
pře krout i t	PRSI
pře kruc ová n í	PRSSS
pře kráj e t	PRSI
pře krás n ý	PRSI
pře krý t	PRI
pře krý v a t	PRSSI
pře kus ova t	PRSI
pře kyp ova t	PRSI
pře kys el i t	PRRSI
pře káž e t	PRSI
pře káž k a	PRSI
pře křič e t	PRSI
pře křič ova t	PRSI
pře kříž i t	PRSI
pře lad i t	PRSI
pře lak ova t	PRSI
pře lam ova t	PRSI
pře let ova t	PRSI
pře lešt i t	PRSI
pře list ova t	PRSI
pře lom i t	PRSI
pře lousk a t	PRSI
pře lousk nou t	PRSI
pře lož i t	PRSI
pře lám a t	PRSI
pře lét nou t	PRSI
pře lét á v a t	PRSSSI
pře léz a t	PRSI
pře léz t	PRI
pře lí t	PRI
pře lít a t	PRSI
pře lít á v a t	PRSSSI
pře lí v a t	PRSSI
pře líz a t	PRSI
pře líč i t	PRSI
pře mal ova t	PRSI
pře mast i t	PRSI
pře mlouv a t	PRSI
pře mlouv á n í	PRSSS
pře mluv i t	PRSI
pře ml í t	PRSI
pře mnoh ý	PRI
pře moc i	PRI
pře mont ova t	PRSI
pře mosť ova n ý	PRSSI
pře mot a t	PRSI
pře mot á v a t	PRSSSI
pře moudř e t	PRSI
pře mrz nou t	PRSI
pře míst i t	PRSI
pře mísť ova t	PRSI
pře měn i t	PRSI
pře měň ova t	PRSI
pře měř i t	PRSI
pře měř ova t	PRSI
pře nech a t	PRSI
pře nech á v a t	PRSSSI
pře noc ova t	PRSI
pře náš e t	PRSI
pře nés t	PRI
pře orient ova t	PRSI
pře pad a t	PRSI
pře pad á v a t	PRSSSI
pře pal ova t	PRSI
pře paž ova t	PRSI
pře pepř i t	PRSI
pře pil ova t	PRSI
pře plat i t	PRSI
pře plav a t	PRSI
pře plav i t	PRSI
pře plav ova t	PRSI
pře pln i t	PRSI
pře plác e t	PRSI
pře plét a t	PRSI
pře plň ova t	PRSI
pře prac ova t	PRSI
pře prac ová v a t	PRSSSI
pře pr a t	PRSI
pře prav i t	PRSI
pře prav ova t	PRSI
pře praž i t	PRSI
pře prch nou t	PRSI
pře prch á v a t	PRSSSI
pře pudr ova t	PRSI
pře pust i t	PRSI
pře péc i	PRI
pře pék a t	PRSI
pře pích a t	PRSI
pře pín a t	PRSI
pře půl i t	PRSI
pře raz i t	PRSI
pře raz í tk ova t	PRSRSI
pře rod i t	PRSI
pře rost š í	PRSI
pře ruš en í	PRSI
pře ruš i t	PRSI
pře rv a t	PRSI
pře ráž e t	PRSI
pře rý t	PRI
pře rý v a n ě	PRSSSI
pře rý v a t	PRSSI
pře růst a t	PRSI
pře sah ova t	PRSI
pře sed ě t	PRSI
pře sek a t	PRSI
pře sek nou t	PRSI
pře sek á v a t	PRSSSI
pře skak ova t	PRSI
pře skoč i t	PRSI
pře slabik ova t	PRSI
pře slad i t	PRSI
pře slaz ova t	PRSI
pře slouž i t	PRSI
pře sluh ova t	PRSI
přesn ý	RI
přesn ě	RS
pře sol i t	PRSI
pře sp a t	PRSI
pře sp á v a t	PRSSSI
pře sta t	PRI
pře stoup i t	PRSI
pře stoup nou t	PRSI
pře stroj i t	PRSI
pře stroj ova t	PRSI
pře stud ova t	PRSI
pře stup ova t	PRSI
pře styl iz ova t	PRSSI
pře stá t	PRI
pře stěh ová v a t	PRSSSI
pře sun ova t	PRSI
pře syc ova t	PRSI
pře syp á v a t	PRSSSI
pře syt i t	PRSI
pře sáh nou t	PRSI
pře sídl i t	PRSI
pře sídl ova t	PRSI
pře sýp a t	PRSI
pře tav i t	PRSI
pře tisk nou t	PRSI
pře tlouc i	PRI
pře tlouk a t	PRSI
pře tlumoč i t	PRSI
pře t nou t	PPPI
pře toč i t	PRSI
pře trh a t	PRSI
pře trh nou t	PRSI
pře trh á v a t	PRSSSI
pře trp ě t	PRSI
pře trumf nou t	PRSI
pře trv a t	PRSI
pře trv á v aj íc í	PRSSSSI
pře trén ova t	PRSI
pře trž en í	PRSI
pře tvař ova t	PRSI
pře tvoř i t	PRSI
pře tvoř ova t	PRSI
pře tvář e t	PRSI
pře táh nou t	PRSI
pře táč e t	PRSI
pře téc i	PRI
pře ték a t	PRSI
pře tír a t	PRSI
pře tíž en í	PRSI
pře tíž i t	PRSI
pře těž ova t	PRSI
pře třep a t	PRSI
pře třás a t	PRSI
pře tříd i t	PRSI
pře uč ova t	PRSI
pře val i t	PRSI
pře vaz ova t	PRSI
pře vař i t	PRSI
pře vař ova t	PRSI
pře vlád a t	PRSI
pře vléc i	PRI
pře vlék a t	PRSI
pře vlík a t	PRSI
pře vrh nou t	PRSI
pře vrh ova t	PRSI
pře vrstv i t	PRSI
pře vrstv ova t	PRSI
pře vrát i t	PRSI
pře v těl i t	PPRSI
pře v těl ova t	PPRSI
pře vy chov a t	PPRSI
pře vys ok o	PRSI
pře vál e t	PRSI
pře vá t	PRI
pře váz a t	PRSI
pře váž e t	PRSI
pře véz t	PRI
pře věs i t	PRSI
pře zd í t	PRSI
pře zd í v a t	PRSSSI
pře zim ova t	PRSI
pře z koum a t	PPRSI
pře z kouš e t	PPRSI
pře znač k ova t	PRSSI
pře zou t	PRI
pře zrá t	PRI
pře zv a t	PRSI
pře zář i t	PRSI
pře čerp á v a t	PRSSSI
pře čes a t	PRSI
pře čin	PR
pře čist i t	PRSI
pře čišť ova t	PRSI
pře čísl ova t	PRSI
pře řad i t	PRSI
pře řaz ova t	PRSI
pře řaď ova t	PRSI
pře řek nou t	PRSI
pře řez a t	PRSI
pře řez á v a t	PRSSSI
pře říc i	PRI
pře řík a t	PRSI
pře řík á v a t	PRSSSI
pře říz nou t	PRSI
pře škol i t	PRSI
pře škol ova t	PRSI
pře škrt a t	PRSI
pře škrt nou t	PRSI
pře škrt á v a t	PRSSSI
pře škvař i t	PRSI
pře šlap ova t	PRSI
pře šlap á v a t	PRSSSI
pře šlecht i t	PRSI
pře šláp nou t	PRSI
pře šmik nou t	PRSI
pře štip ova t	PRSI
pře štíp nou t	PRSI
pře švih nou t	PRSI
pře ší t	PRI
pře ší v a t	PRSSI
pře žehl i t	PRSI
pře žvyk ova t	PRSI
pře žvýk a t	PRSI
pře žvýk á v a t	PRSSSI
pře ží v a t	PRSSI
při bal i t	PRSI
při bal ova t	PRSI
při barv i t	PRSI
při belh a t	PRSI
při bliž n ě	PRSI
při bliž ova t	PRSI
při blíž i t	PRSI
při bod nou t	PRSI
při bouch nou t	PRSI
při bouch á v a t	PRSSSI
při brous i t	PRSI
při brzd i t	PRSI
při bud ova t	PRSI
při básn i t	PRSI
při bý t	PRI
při bý v a t	PRSSI
při cap a t	PRSI
při cap k a t	PRSSI
při cest ova t	PRSI
při chvát a t	PRSI
při chvát nou t	PRSI
při chyst a t	PRSI
při chyt a t	PRSI
při chyt i t	PRSI
při chyt nou t	PRSI
při chyt á v a t	PRSSSI
při cvál a t	PRSI
při draž i t	PRSI
při drk ot a t	PRSSI
při drnc a t	PRSI
při druž i t	PRSI
při druž ova t	PRSI
při dus i t	PRSI
při děl a t	PRSI
při děl i t	PRSI
při děl ova t	PRSI
při haz ova t	PRSI
při hlad i t	PRSI
při hlaz ova t	PRSI
při hnoj i t	PRSI
při hnoj ova t	PRSI
při hobl ova t	PRSI
při hop k a t	PRRSI
při hop k ova t	PRRSI
při hops a t	PRSI
při hotov i t	PRSI
při hrb i t	PRSI
při hr nou t	PRSI
při hrot i t	PRSI
při hák ova t	PRSI
při háč k ova t	PRSSI
při hýb a t	PRSI
při hřá t	PRI
při hřá v a t	PRSSI
při hří v a t	PRSSI
při j a t ý	PRSSI
při jedn a t	PRSI
při je t	PRI
při j e t í	PRSSI
při juch a t	PRSI
při jím ac í	PRSI
při jím aj íc í	PRSSI
při jím a t	PRSI
při jím á n í	PRSSS
při jí t	PRI
při jížd ě t	PRSI
při kap a t	PRSI
při kaz ova t	PRSI
při klap nou t	PRSI
při klap ova t	PRSI
při klep nou t	PRSI
při klon i t	PRSI
při klop i t	PRSI
při klop ova t	PRSI
při klopýt a t	PRSI
při klus a t	PRSI
při klán ě t	PRSI
při kláp ě t	PRSI
při klíž i t	PRSI
při koléb a t	PRSI
při kolíb a t	PRSI
při kol ík ova t	PRSSI
při koup i t	PRSI
při kous nou t	PRSI
při kouzl i t	PRSI
při kořen i t	PRSI
při kraj ova t	PRSI
při kraš l ova t	PRSSI
při krm ova t	PRSI
při kroj i t	PRSI
při kry t ý	PRSI
při krád a t	PRSI
při kráj e t	PRSI
při kráš l i t	PRSSI
při krý v a t	PRSSI
při krč i t	PRSI
při kulh a t	PRSI
při kus ova t	PRSI
při kutál e t	PRSI
při kys el i t	PRRSI
při kyv ova t	PRSI
při káp nou t	PRSI
při káz a t	PRSI
při kýv nou t	PRSI
při let ě t	PRSI
při loud a t	PRSI
při lák a t	PRSI
při lát a t	PRSI
při lét a t	PRSI
při lé v a t	PRSSI
při léz a t	PRSI
při lín a t	PRSI
při lí v a t	PRSSI
při líz a t	PRSI
při mast i t	PRSI
při mhouř i t	PRSI
při mhuř ova t	PRSI
při mlouv a t	PRSI
při mluv i t	PRSI
při mont ova t	PRSI
při mot a t	PRSI
při mraz i t	PRSI
při mysl e t	PRSI
při máz nou t	PRSI
při mích a t	PRSI
při mích á v a t	PRSSSI
při mýšl e t	PRSI
při měř en ost	PRSS
při měř en ý	PRSI
při měř i t	PRSI
při nož i t	PRSI
při nut i t	PRSI
při nés t	PRI
při nýt ova t	PRSI
při o dí t	PPRI
při o dí v a t	PPRSSI
při ostř i t	PRSI
při o tráv i t	PPRSI
při pacht ova t	PRSI
při pad a t	PRSI
při pad nou t	PRSI
při pad á v a t	PRSSSI
při pal ova t	PRSI
při pamat ova t	PRSI
při paž i t	PRSI
při paž ova t	PRSI
při pepř i t	PRSI
při pich ova t	PRSI
při pil ova t	PRSI
při pis ova t	PRSI
při plat i t	PRSI
při plav a t	PRSI
při plaz i t	PRSI
při plác e t	PRSI
při plác nou t	PRSI
při plét a t	PRSI
při pout a t	PRSI
při pout á v a t	PRSSSI
při poušt ě t	PRSI
při pozd i t	PRSI
při pozd í v a t	PRSSSI
při praž i t	PRSI
při prásk nou t	PRSI
při ps a t	PRSI
při pudr ova t	PRSI
při pump ova t	PRSI
při pust i t	PRSI
při put ova t	PRSI
při páj e t	PRSI
při péc i	PRI
při pék a t	PRSI
při pích á v a t	PRSSSI
při pín a t	PRSI
při raz i t	PRSI
při roub ova t	PRSI
při rovn á n í	PRSSS
při ráž e t	PRSI
při ráž k a	PRSI
při růst a t	PRSI
při sch nou t	PRSI
při sek a t	PRSI
při sek nou t	PRSI
při sek á v a t	PRSSSI
při skak ova t	PRSI
při skoč i t	PRSI
při skříp nou t	PRSI
při slad i t	PRSI
při slaz ova t	PRSI
při sluh ova t	PRSI
při sol i t	PRSI
při soud i t	PRSI
při spoř i t	PRSI
při spí v a t	PRSSI
při spěch a t	PRSI
při spěch á v a t	PRSSSI
při spě t	PRI
při steh ova t	PRSI
při stih nou t	PRSI
při stih ova t	PRSI
při stoup i t	PRSI
při strk á v a t	PRSSSI
při stroj ova t	PRSI
při strč i t	PRSI
při stá t	PRI
při stá v a t	PRSSI
při suz ova t	PRSI
při svíc en í	PRSI
při syp a t	PRSI
při syp á v a t	PRSSSI
při sá t	PRI
při sá v a t	PRSSI
při sýp a t	PRSI
při tah ova t	PRSI
při tanc ova t	PRSI
při tanč i t	PRSI
při tes á v a t	PRSSSI
při tisk nou t	PRSI
při tisk ova t	PRSI
při tišt ěn ý	PRSI
při tlač i t	PRSI
při tlouc i	PRI
při tlouk a t	PRSI
při tlum i t	PRSI
při toč i t	PRSI
při tref i t	PRSI
při trh nou t	PRSI
při tuh nou t	PRSI
při tuh ova t	PRSI
při tul i t	PRSI
při tuž i t	PRSI
při tuž ova t	PRSI
při ték a t	PRSI
při tíž i t	PRSI
při těž ova t	PRSI
při tř í t	PRSI
při uč ova t	PRSI
při val i t	PRSI
při val ova t	PRSI
při vandr ova t	PRSI
při vař i t	PRSI
při vař ova t	PRSI
při vesl ova t	PRSI
při vlast ň ova t	PRSSI
při vléc i	PRI
při vlék a t	PRSI
při vol a t	PRSI
při vol i t	PRSI
při vol á n í	PRSSS
při von ě t	PRSI
při vrávor a t	PRSI
při v těl i t	PPRSI
při v těl ova t	PPRSI
při vy děl a t	PPRSI
při váb i t	PRSI
při vál e t	PRSI
při vá t	PRI
při váz a t	PRSI
při váž e t	PRSI
při véz t	PRI
při vír a t	PRSI
při vít a t	PRSI
při vý děl ek	PPRI
při věš ova t	PRSI
při vř í t	PRSI
při zd í t	PRSI
při zn á n í	PRSSS
při zn á v a t	PRSSSI
při zv a t	PRSI
při čar ova t	PRSI
při čes a t	PRSI
při čes á v a t	PRSSSI
při čin i t	PRSI
při čiň ova t	PRSI
při člen i t	PRSI
při čleň ova t	PRSI
při čmár a t	PRSI
při čuch nou t	PRSI
při řad i t	PRSI
při řaz ova t	PRSI
při řez a t	PRSI
při řez á v a t	PRSSSI
při řít i t	PRSI
při říz nou t	PRSI
při škol i t	PRSI
při škrob i t	PRSI
při škrt i t	PRSI
při škvař i t	PRSI
při šlap á v a t	PRSSSI
při šláp nou t	PRSI
při šněr ova t	PRSI
při šour a t	PRSI
při špendl i t	PRSI
při šroub ova t	PRSI
při štip ova t	PRSI
při štíp nou t	PRSI
při šum ě t	PRSI
při ší t	PRI
při ší v a t	PRSSI
při žen i t	PRSI
přá n í	RSS
přá t	RI
pří jem	PR
pří kaz	PR
přím i t	RSI
přím o	RI
přím ý	RI
pří ruč í	PRI
pří sah a	PRI
pří sah a t	PRSI
pří sluš en stv í	PRSSS
pří sluš e t	PRSI
pří sluš ník	PRS
pří spě v ek	PRSI
pří stroj	PR
pří stup	PR
př í t	RSI
přítel	R
přítel íček	RS
pří zvuk ova t	PRSI
příč i t	RSI
půjč i t	RSI
půl	R
půl i t	RSI
půl k a	RSI
rab ova t	RSI
rad i t	RSI
rad ost	RS
rad ost n ě	RSSI
ran i t	RSI
ran ěn ý	RSI
raz i t	RSI
raz í tk o	RSRI
raž b a	RSI
raž en í	RSI
rd í t	RSI
re akc e	PRI
real it a	RSI
real iz ova t	RSSI
rebel ova t	RSI
re cit ova t	PRSI
redig ova t	RSI
reduk ova t	RSI
re form ova t	PRSI
re form átor	PRS
registr ac e	RSI
registr ač n í	RSSI
registr ova t	RSI
regul ace	RS
regul ova n ý	RSSI
regul ova t	RSI
re komand ova t	PRSI
relat iv izová n í	RSSSS
re prezent ova t	PRSI
re sign ova t	PRSI
re vid ova t	PRSI
rez av ě n í	RSSSI
rez avě t	RSI
reál n ý	RSI
reál n ě	RSI
rmout i t	RSI
rob i t	RSI
rod	R
rod in a	RSI
rod in n ý	RSSI
rod i t	RSI
rod ác k ý	RSSI
rod ák	RS
roh	R
roh ova t	RSI
roh ovin n ý	RSSI
roj i t	RSI
rok	R
rol ova t	RSI
rol uj íc í	RSSI
romant ic k ý	RRSI
román	R
ros i t	RSI
ros ičk a	RSI
ros n ý	RSI
rost lin a	RSI
rost ou c í	RSSI
roub i t	RSI
roub ova t	RSI
rovin a	RI
rovn a t	RSI
rovn ic e	RSI
rovn ost	RS
rovn ou	RI
roz bahn i t	PRSI
roz bal i t	PRSI
roz bal ova t	PRSI
roz bod a t	PRSI
roz bol e t	PRSI
roz bour a t	PRSI
roz bouř i t	PRSI
roz boř i t	PRSI
roz breč e t	PRSI
roz bruč e t	PRSI
roz buj e t	PRSI
roz buš i t	PRSI
roz běs n i t	PRSSI
roz checht a t	PRSI
roz chod i t	PPPI
roz chrchl a t	PRSI
roz chyt á v a t	PRSSSI
roz cház e t	PPPI
roz cour a t	PRSI
roz cvič i t	PRSI
roz cvič ova t	PRSI
roz div oč i t	PRRSI
roz dloub a t	PRSI
roz drk ot a t	PRSSI
roz drob i t	PRSI
roz drol i t	PRSI
roz dráp a t	PRSI
roz drás a t	PRSI
roz drážd i t	PRSI
roz dup a t	PRSI
roz dým a t	PRSI
roz děl a t	PRSI
roz děl i t	PRSI
roz děl á v a t	PRSSSI
roze chví v a t	PRSSI
roze chvě t	PRI
roze dm ou t	PRSI
roze dř í t	PRSI
roze hrá t	PRI
roze hrá v a t	PRSSI
roze hřá t	PRI
roze hřá v a t	PRSSI
roze hří v a t	PRSSI
roze jí t	PRI
roze ml í t	PRSI
roze pín a t	PRSI
roze př í t	PRSI
roze sch nou t	PRSI
roze smut n i t	PRSSI
roze smut n ě t	PRSSI
roze smut ň ova t	PRSSI
roze smá t	PRI
roze stl a t	PRSI
roze stýl a t	PRSI
roze t nou t	PPPI
roze tř í t	PRSI
roze vlá t	PRI
roze vír a t	PRSI
roze vř e n ý	PRSSI
roze vř í t	PRSI
roze zn a t	PRSI
roze zn á v a t	PRSSSI
roze zn í t	PRSI
roze zn í v a t	PRSSSI
roze zvuč e t	PRSI
roze řv a t	PRSI
roze štv a t	PRSI
roze ší t	PRI
roz flák a n ý	PRSSI
roz fouk a t	PRSI
roz fouk nou t	PRSI
roz fouk á v a t	PRSSSI
roz fuk ova t	PRSI
roz fňuk a t	PRSI
roz hal i t	PRSI
roz hal ova t	PRSI
roz haz ova t	PRSI
roz hlaš ova t	PRSI
roz hlod a t	PRSI
roz hlod á v a t	PRSSSI
roz hlás i t	PRSI
roz hod i t	PRSI
roz hod n ý	PRSI
roz hod n ě	PRSS
roz horl i t	PRSI
roz horl ova t	PRSI
roz houk a t	PRSI
roz houp a t	PRSI
roz houp á v a t	PRSSSI
roz hovor	PR
roz hovoř i t	PRSI
roz hoz en ý	PRSI
roz hrab a t	PRSI
roz hrab ova t	PRSI
roz hrab á v a t	PRSSSI
roz hran ič i t	PRSSI
roz hran ič ova t	PRSSI
roz hryz a t	PRSI
roz hryz nou t	PRSI
roz hryz á v a t	PRSSSI
roz ház e t	PRSI
roz hýb a t	PRSI
roz hýb á v a t	PRSSSI
roz hří v a t	PRSSI
roz jas n i t	PRSSI
roz jas ň ova t	PRSSI
roz je t	PRI
roz jezd i t	PRSI
roz ječ e t	PRSI
roz jež i t	PRSI
roz jizv i t	PRSI
roz jás a t	PRSI
roz kašl a t	PRSI
roz kec a t	PRSI
roz klap a t	PRSI
roz kliž ova t	PRSI
roz klov a t	PRSI
roz klov nou t	PRSI
roz klábos i t	PRSI
roz klíž i t	PRSI
roz koléb a t	PRSI
roz koléb á v a t	PRSSSI
roz kolíb a t	PRSI
roz kolís a n ost	PRSSS
roz kolís a t	PRSI
roz kop a t	PRSI
roz kop nou t	PRSI
roz kouk á v a t	PRSSSI
roz kous a t	PRSI
roz kous nou t	PRSI
roz kous á v a t	PRSSSI
roz kraj ova t	PRSI
roz kram ař i t	PRSSI
roz kroj i t	PRSI
roz kroj ova t	PRSI
roz krád a t	PRSI
roz kráj e t	PRSI
roz kuch a t	PRSI
roz kus ova t	PRSI
roz kvas i t	PRSI
roz kvés t	PRI
roz kvét a t	PRSI
roz kyd a t	PRSI
roz káz a t	PRSI
roz kých a t	PRSI
roz kýv nou t	PRSI
roz kýv á v a t	PRSSSI
roz křes a t	PRSI
roz křik nou t	PRSI
roz křik ova t	PRSI
roz křáp nou t	PRSI
roz lad i t	PRSI
roz laď ova t	PRSI
roz lept a t	PRSI
roz lept á v a t	PRSSSI
roz let ě t	PRSI
roz liš en í	PRSI
roz liš ova c í	PRSSI
roz liš ova t	PRSI
roz lom i t	PRSI
roz los ova t	PRSI
roz loup a t	PRSI
roz loup nou t	PRSI
roz lousk a t	PRSI
roz lousk nou t	PRSI
roz lousk á v a t	PRSSSI
roz louč en á	PRSI
roz louč en í	PRSI
roz louč i t	PRSI
roz lup ova t	PRSI
roz luč ova t	PRSI
roz lušt i t	PRSI
roz lušt ěn í	PRSI
roz lám a t	PRSI
roz lét a t	PRSI
roz lét á v a t	PRSSSI
roz léz t	PRI
roz lí t	PRI
roz lít á v a t	PRSSSI
roz lí v a t	PRSSI
roz maz a t	PRSI
roz mazl i t	PRSI
roz mazl ova t	PRSI
roz maz ova t	PRSI
roz maz á v a t	PRSSSI
roz mačk a t	PRSI
roz met a t	PRSI
roz met á v a t	PRSSSI
roz mlouv a t	PRSI
roz mluv i t	PRSI
roz mlát i t	PRSI
roz množ i t	PRSI
roz množ ova t	PRSI
roz mok nou t	PRSI
roz mont ova t	PRSI
roz mot á v a t	PRSSSI
roz moč i t	PRSI
roz mrh a t	PRSI
roz mrz ova t	PRSI
roz mysl e t	PRSI
roz mysl i t	PRSI
roz mách nou t	PRSI
roz máh a t	PRSI
roz máč e t	PRSI
roz mích a t	PRSI
roz mích á v a t	PRSSSI
roz míst i t	PRSI
roz mísť ova t	PRSI
roz měk č i t	PRSSI
roz měn i t	PRSI
roz měň ova t	PRSI
roz měň uj íc í	PRSSI
roz měř i t	PRSI
roz měř ova t	PRSI
roz nož i t	PRSI
roz nož ova t	PRSI
roz náš e t	PRSI
roz nés t	PRI
roz nýt ova t	PRSI
roz pad a t	PRSI
roz pad a v ý	PRSSI
roz pad nou t	PRSI
roz pad á v a t	PRSSSI
roz pal ova t	PRSI
roz parcel ova t	PRSI
roz par ova t	PRSI
roz patl a t	PRSI
roz pař ova t	PRSI
roz paž ova t	PRSI
roz pečet i t	PRSI
roz pich ova t	PRSI
roz pitv a t	PRSI
roz plak a n ý	PRSSI
roz plak a t	PRSI
roz plaš i t	PRSI
roz plesk nou t	PRSI
roz plod i t	PRSI
roz ploz ova t	PRSI
roz ply nou t	PRSI
roz plác nou t	PRSI
roz plán ova t	PRSI
roz plét a t	PRSI
roz plýtv a t	PRSI
roz plý v a t	PRSSI
roz po síl a t	PPRSI
roz pout a t	PRSI
roz pout á v a t	PRSSSI
roz poušt ě t	PRSI
roz po víd a t	PPRSI
roz prac ova t	PRSI
roz prac ová v a t	PRSSSI
roz prask a t	PRSI
roz prask á v a t	PRSSSI
roz praš ova t	PRSI
roz prch nou t	PRSI
roz prch á v a t	PRSSSI
roz prsk nou t	PRSI
roz prýsk a t	PRSI
roz prš e t	PRSI
roz pust i t	PRSI
roz puč e t	PRSI
roz pál i t	PRSI
roz pár a t	PRSI
roz péc i	PRI
roz pék a t	PRSI
roz pích a t	PRSI
roz pích nou t	PRSI
roz pích á v a t	PRSSSI
roz pěn i t	PRSI
roz půjč i t	PRSI
roz rad ost n i t	PRSSSI
roz rad ova t	PRSI
roz raz i t	PRSI
roz ruš i t	PRSI
roz ruš ova t	PRSI
roz ry v n ý	PRSSI
roz ráž e t	PRSI
roz rýp a t	PRSI
roz rýp á v a t	PRSSSI
roz rý t	PRI
roz rý v a t	PRSSI
roz růst a t	PRSI
roz různ i t	PRSI
roz růzň ova t	PRSI
roz sed ě t	PRSI
roz sek a t	PRSI
roz sek nou t	PRSI
roz sek á v a t	PRSSSI
roz skoč i t	PRSI
roz slz e t	PRSI
roz soud i t	PRSI
roz ston a t	PRSI
roz strk a t	PRSI
roz strk á v a t	PRSSSI
roz strouh a t	PRSI
roz stup ova t	PRSI
roz střel i t	PRSI
roz střel ova t	PRSI
roz střik ova t	PRSI
roz střík a t	PRSI
roz střík nou t	PRSI
roz stříl e t	PRSI
roz svít i t	PRSI
roz svěc ova t	PRSI
roz syp a t	PRSI
roz sýp a t	PRSI
roz tah a t	PRSI
roz tah ova t	PRSI
roz tanč i t	PRSI
roz tav i t	PRSI
roz tav ova t	PRSI
roz taž en ý	PRSI
roz tep a t	PRSI
roz tesk n i t	PRSSI
roz tesk ň ova t	PRSSI
roz tlouc i	PRI
roz tlouk a t	PRSI
roz toč i t	PRSI
roz trh a t	PRSI
roz trh ova t	PRSI
roz trh á v a t	PRSSSI
roz troub i t	PRSI
roz trub ova t	PRSI
roz truš ova t	PRSI
roz táh nou t	PRSI
roz tá t	PRI
roz tá v a t	PRSSI
roz táč e t	PRSI
roz téc i	PRI
roz těk a t	PRSI
roz třep a t	PRSI
roz třep i t	PRSI
roz třep ova t	PRSI
roz třep á v a t	PRSSSI
roz třiď ova t	PRSI
roz třás a t	PRSI
roz třás t	PRI
roz tříd i t	PRSI
roz tříd ěn í	PRSI
roz třísk a t	PRSI
roz třísk nou t	PRSI
roz um	PR
roz um n ý	PRSI
roz um ář	PRS
roz um ě t	PRSI
roz u téc i	PPRI
roz vad i t	PRSI
roz val i t	PRSI
roz val ova t	PRSI
roz vaz ova t	PRSI
roz vař ova t	PRSI
roz vesel i t	PRSI
roz vikl á v a t	PRSSSI
roz viř ova t	PRSI
roz vln i t	PRSI
roz vlék a t	PRSI
roz vod n i t	PRSSI
roz vod ň ova t	PRSSI
roz vrac e t	PRSI
roz vrh nou t	PRSI
roz vrh ova t	PRSI
roz vrt a t	PRSI
roz vrt á v a t	PRSSSI
roz vrát i t	PRSI
roz vá t	PRI
roz váz a t	PRSI
roz váz á n í	PRSSS
roz váž e n ě	PRSSI
roz váž e t	PRSI
roz véz t	PRI
roz víj ej íc í	PRSSI
roz víj e t	PRSI
roz vír a t	PRSI
roz ví t	PRI
roz věs i t	PRSI
roz větv en ý	PRSI
roz větv i t	PRSI
roz větv ova t	PRSI
roz věš ova t	PRSI
roz vřísk a t	PRSI
roz vřísk nou t	PRSI
roz zl ob i t	PRSSI
roz zuř i t	PRSI
roz zuř ova t	PRSI
roz zář i t	PRSI
roz zív a t	PRSI
roz čechr a t	PRSI
roz čepýř i t	PRSI
roz čert i t	PRSI
roz čes a t	PRSI
roz čes á v a t	PRSSSI
roz čeř i t	PRSI
roz člen i t	PRSI
roz čleň ova t	PRSI
roz čtvrt i t	PRSI
roz řaz ova t	PRSI
roz řed i t	PRSI
roz řez a t	PRSI
roz řez á v a t	PRSSSI
roz řeď ova t	PRSI
roz řeš en í	PRSI
roz řeš i t	PRSI
roz řeš i teln ý	PRSSI
roz šiř ova t	PRSI
roz škleb i t	PRSI
roz škrt á v a t	PRSSSI
roz škub nou t	PRSI
roz škub á v a t	PRSSSI
roz škvař i t	PRSI
roz šlap a t	PRSI
roz šlap á v a t	PRSSSI
roz šleh a t	PRSI
roz šleh á v a t	PRSSSI
roz šláp nou t	PRSI
roz šmik a t	PRSI
roz šněr ová v a t	PRSSSI
roz šroub ova t	PRSI
roz štíp a t	PRSI
roz štíp nou t	PRSI
roz štíp á v a t	PRSSSI
roz štěp i t	PRSI
roz štěp ova t	PRSI
roz šum ě t	PRSI
roz šíř en í	PRSI
roz šíř en ý	PRSI
roz šíř i t	PRSI
roz žehn a t	PRSI
roz žeh nou t	PRSI
roz žeh ova t	PRSI
roz žh av i t	PRSSI
roz žh av ova t	PRSSI
roz žmol i t	PRSI
roz žmoul a t	PRSI
roz žvatl a t	PRSI
roz žvýk a t	PRSI
roz žíh a t	PRSI
roč n í	RSI
roč n ě	RSI
rub a t	RSS
rud nou t	RSI
rud ý	RI
rud ě	RI
ruk a	RI
rus	R
ruč i t	RSI
ruš en í	RSI
ruš i t	RSI
ruš n ý	RSI
ruš tin a	RSI
rv a č k a	RSSSI
rv á t	RSI
rv á č	RSS
ryb a	RI
ryb ař i t	RSSI
ryb ičk a	RSI
rychl e	RI
rychl i t	RSI
rychl ost	RS
rychl ý	RI
rys	R
rád c e	RSI
rám ec	RI
ráč ek	RI
rýh ova t	RSI
rým ova t	RSI
rýp a t	RSI
rýs ova t	RSI
rý t	RI
růst	R
různ i t	RSI
růž e	RI
růž ičk ov ý	RSSI
růž ov ý	RSI
sabot áž	RS
sah a t	RSI
s bal en í	PRSI
s bal i t	PRSI
s bliž ova t	PRSI
s blíž i t	PRSI
s bratř ova t	PRSI
s bubn ova t	PRSI
s bíh a t	PRSI
s běh nou t	PRSI
s ced i t	PRSI
scen ér i e	RSSI
s cest ova t	PRSI
s cez ova t	PRSI
sch nou t	RSI
s chop n ost	PRSS
s chop n ý	PRSI
s chov á v a t	PRSSSI
s chraň ova t	PRSI
s chrup a t	PRSI
s chrup nou t	PRSI
s chval ova c í	PRSSI
s chval ova t	PRSI
s chvál i t	PRSI
s chyl ova t	PRSI
s chyt á v a t	PRSSSI
s cház e t	PPPI
s chýl i t	PRSI
s cuk nou t	PRSI
s drh ova t	PRSI
s druž i t	PRSI
s druž ova t	PRSI
s drát ova t	PRSI
s díl e t	PRSI
s dír a t	PRSI
s děl en í	PRSI
s děl i t	PRSI
s děl ova t	PRSI
s děl á v a t	PRSSSI
se běh nou t	PRSI
se cvič i t	PRSI
se cvič ova t	PRSI
sed íc í	RSI
sed ě t	RSI
se dř í t	PRSI
se hrá n í	PRSS
se jím a t	PRSI
se jí t	PRI
sek a t	RSI
sekund ova t	RSI
se lh a t	PRSI
se lh á n í	PRSSS
se lh á v a t	PRSSSI
se ml í t	PRSI
se míl a t	PRSI
sen	R
separ ova t	RSI
se pis ova t	PRSI
se pis ová n í	PRSSS
se pr a t	PRSI
se rv a t	PRSI
se sek a t	PRSI
se sek nou t	PRSI
se sek á v a t	PRSSSI
se skoč i t	PRSI
se skák a t	PRSI
se smol i t	PRSI
se souk a t	PRSI
se sta v en ý	PRSSI
se strk ova t	PRSI
se stroj i t	PRSI
se stroj ova t	PRSI
se strč i t	PRSI
se styl iz ova t	PRSSI
se stá v a t	PRSSI
se střel i t	PRSI
se střel ova t	PRSI
se sun ova t	PRSI
se syp a t	PRSI
se syp á v a t	PRSSSI
se sýp a t	PRSI
se tm í t	PRSI
se t nou t	PPPI
se trv a l ý	PRSSI
se trv a t	PRSI
se trv á v a t	PRSSSI
se třep a t	PRSI
se třep á v a t	PRSSSI
se třás a t	PRSI
se třás t	PRI
se třás á v a t	PRSSSI
se tř í t	PRSI
se vř e n ě	PRSSI
se vř í t	PRSI
sez e n í	RSSI
se zn a c í	PRSSI
se zn a t	PRSI
se zn á v a t	PRSSSI
se zob a t	PRSI
se zob nou t	PRSI
se zob á v a t	PRSSSI
se zv a t	PRSI
se čk a t	PRSI
se řad i t	PRSI
se řaz ova t	PRSI
se řaď ova t	PRSI
se řez a t	PRSI
se řiz ova t	PRSI
se říz nou t	PRSI
se šik ova t	PRSI
se škleb i t	PRSI
se šlap a t	PRSI
se šlap ova t	PRSI
se šleh a t	PRSI
se š l ost	PPPP
se šláp nou t	PRSI
se šmajd a t	PRSI
se šmodrch a t	PRSI
se šoup nou t	PRSI
se šoup á v a t	PRSSSI
se šplh a t	PRSI
se šroub ova t	PRSI
se štel ova n ý	PRSSI
se šup ova t	PRSI
se ší t	PRI
se ší v a t	PRSSI
se žeh nou t	PRSI
se žmol i t	PRSI
se žmoul a t	PRSI
se žr a t	PRSI
se žvýk a t	PRSI
se žvýk nou t	PRSI
se žvýk á v a t	PRSSSI
se žín a t	PRSI
s fouk a t	PRSI
s fouk nou t	PRSI
s fouk á v a t	PRSSSI
s fuk ova t	PRSI
s fár a t	PRSI
s haz ova t	PRSI
s hlad i t	PRSI
s hlaz ova t	PRSI
s hled á v a t	PRSSSI
s hléd nou t	PRSI
s hlíž e t	PRSI
s hní t	PRI
s hod i t	PRSI
s hrab a t	PRSI
s hrab ova t	PRSI
s hrab ová n í	PRSSS
s hrab á v a t	PRSSSI
s hrb i t	PRSI
s hr nou t	PRSI
s hr nu t í	PRSSI
s hromažď ova t	PRSI
s hromážd i t	PRSI
s hráb nou t	PRSI
s hán ě t	PRSI
sil n ic e	RSSI
sil n ý	RSI
sil n ě	RSI
simul ova t	RSI
sir k a	RSI
s jedn oc ova t	PRRSI
s jedn oc uj íc í	PRRSSI
s jedn ot i t	PRRSI
s jedn á v a t	PRSSSI
s je t	PRI
s jížd ě t	PRSI
skal n í	RSI
s kap a t	PRSI
s klad a tel	PRSR
s klad b a	PRSI
s klad ova t	RRSI
s klap nou t	PRSI
s klap ova t	PRSI
skl en ic e	RSSI
skl en ík	RSS
s klep a t	PRSI
s klep á v a t	PRSSSI
skl o	RI
s klon i t	PRSI
s klop en ý	PRSI
s klop i t	PRSI
s kloub i t	PRSI
s klouz a t	PRSI
s klouz nou t	PRSI
s klouz á v a t	PRSSSI
s kloň ova t	PRSI
s klád a t	RRSI
s klán ě t	PRSI
s kláp ě t	PRSI
s klát i t	PRSI
s klíz e t	PRSI
s klíč i t	PRSI
skl íčk o	RSI
skok	R
s konc ova t	PRSI
s kop nou t	PRSI
s kos i t	PRSI
s koul e t	PRSI
s koup i t	PRSI
s kous nou t	PRSI
skoč i t	RSI
s krout i t	PRSI
s kruc ova t	PRSI
s kráj e t	PRSI
s kráp ě t	PRSI
s krý t	PRI
s krý v a t	PRSSI
s krč i t	PRSI
s kul i t	PRSI
s kup i t	PRSI
s kup ova t	PRSI
s kup ová v a t	PRSSSI
skutek	R
skuteč n ost	RSS
skuteč n ý	RSI
s kutál e t	PRSI
s kác e t	PRSI
skál a	RI
s káp nou t	PRSI
skýt a t	RSI
skříp a t	RSI
skříp nou t	RSI
slabik ova t	RSI
slab in a	RSI
slab ost	RS
slab oun c e	RSSI
slab ě	RI
slad c e	RSI
slad i t	RSI
slad k ý	RSI
slav i t	RSI
slav n ý	RSI
slav n ě	RSI
sled ova t	RSI
slep ic e	RSI
slep nou t	RSI
slep ý	RI
s let	PR
s let ova t	PRSI
s let ě t	PRSI
s lev a	PRI
s lev i t	PRSI
s lev ova t	PRSI
slin i t	RSI
s lis ova t	PRSI
s lit ova t	PRSI
s lit ová n í	PRSSS
s lič n ě	PRSI
s loup a t	PRSI
s loup nou t	PRSI
s louč i t	PRSI
slouž i t	RSI
s lož en in a	PRSSI
s lož i t	PRSI
sluch	R
sluch á tk o	RSRI
slun eč n í	RSSI
slun i t	RSI
s lup ova t	PRSI
s luč ova t	PRSI
sluš n ý	RSI
sluš n ě	RSI
služ ba	RI
služ b ičk ova t	RSSSI
služ eb n á	RSSI
služ eb n ě	RSSI
slz a	RI
slz e t	RSI
sláb nou t	RSI
slád nou t	RSI
slám a	RI
s lát a t	PRSI
sláv a	RI
s lét a t	PRSI
s lét nou t	PRSI
s lé v a t	PRSSI
s léz a t	PRSI
s líb a t	PRSI
s lí t	PRI
s lít á v a t	PRSSSI
s líz a t	PRSI
s líz nou t	PRSI
slých á v a t	RSSSI
s maz a t	PRSI
s mačk a t	PRSI
smaž en ý	RSI
smaž i t	RSI
s mil ova t	PRSI
s mil ová v a t	PRSSSI
s mlouv a	PRI
s mlouv a t	PRSI
s mluv i t	PRSI
s mlč e t	PRSI
smol i t	RSI
s mont ova t	PRSI
s mot a t	PRSI
s mot á v a t	PRSSSI
s moč i t	PRSI
smrk a t	RSI
smrk áč	RS
s mrsk a t	PRSI
s mrsk nou t	PRSI
s mrsk ova t	PRSI
s mrsk á v a t	PRSSSI
s mr t	PRI
s mr t k a	PRSSI
smut n o	RSI
smut n ě	RSI
smut n ě t	RSSI
smá t	RI
s máč e t	PRSI
s més t	PRI
s mích a t	PRSI
s mý t	PRI
s mý v a t	PRSSI
s mýšl e t	PRSI
s měn a	PRI
s měn i t	PRSI
s měň ova t	PRSI
s niž ova t	PRSI
s niž ová n í	PRSSS
s nos i t	PRSI
snoub i t	RSI
sn ova t	RSI
s náš e t	PRSI
s nés t	PRI
s níd a n ě	PRSSI
s níd a t	PRSI
sníh	R
sn í l k ovsk y	RSSSRI
s ním a t	PRSI
s ním ek	PRI
s ním k ova t	PRSSI
s níž en í	PRSI
sol i t	RSI
sond ova t	RSI
sou cit n ý	PRSI
sou cit n ě	PRSI
sou cít i t	PRSI
soud	R
soud c ova t	RSSI
soud i t	RSI
soud n í	RSI
sou hvězd í	PRS
souk a t	RSI
souk en ic e	RSSI
sou střed i t	PRSI
sou střed ěn í	PRSI
sou střeď ova t	PRSI
sou vis ej íc í	PRRSI
sou vis e t	PRSI
sou zn í t	PRSI
sou čas n ý	PRSI
sou čas n ě	PRSI
sou část	PR
soč i t	RSI
s pad nou t	PRSI
s pal ova t	PRSI
sp a n í	RSSS
s patř i t	PRSI
s pař i t	PRSI
spekul at iv n í	RSSSI
spekul ova t	RSI
s pil ova t	PRSI
sp ink a t	RSSI
s pis ova t	PRSI
s pis ova tel	PRSS
s plat i t	PRSI
s plat n ost	PRSS
s plav	PR
s plav i t	PRSI
s plav n i t	PRSSI
s plaš i t	PRSI
s ply nou t	PRSI
s plác a t	PRSI
s plác e n í	PRSSI
s plác e t	PRSI
s plét a t	PRSI
s plý v a t	PRSSI
s plň ova t	PRSI
sport ova t	RSI
s po třeb ova t	PPRSI
s pout a t	PRSI
s poušt ě t	PRSI
spoř i l ov sk ý	RSSSSI
spoř i t	RSI
s po řád a t	PPRSI
s prav i t	PRSI
s prav ova t	PRSI
s praž i t	PRSI
s prch nou t	PRSI
s prch ova t	PRSI
s prásk nou t	PRSI
s pust i t	PRSI
s pách a t	PRSI
s páj e t	PRSI
s pál en išt ě	PRSSI
s pál i t	PRSI
sp á n ek	RSSI
s pár a t	PRSI
s pás a	PRI
s pás a t	PRSI
s pás t	PRI
sp á t	RSI
s písk a t	PRSI
spěch a t	RSI
s pěch ova t	PRSI
spě t	RI
spěš n ě	RSI
s raz i t	PRSI
srdc e	RI
srk a t	RSI
srk nou t	RSI
s rol ova t	PRSI
s roub i t	PRSI
s rovn á n í	PRSSS
s roz um ě t	PPRSI
sr á t	RSI
s ráž e t	PRSI
s ráž k a	PRSI
s růst a t	PRSI
stabil iz ova t	RSSI
s tah ova t	PRSI
standard	R
standard iz ova t	RSSI
standard n í	RSI
sta nic e	RSI
sta nou t	RSI
star och	RS
star ost	RS
star ost a	RSI
star ost ova t	RSSI
start ova t	RSI
stač i t	RSI
stař ec	RI
stař ík	RS
steh ova t	RSI
s tep a t	PRSI
steril iz ova t	RSSI
s tes a t	PRSI
s tes á v a t	PRSSSI
stih nou t	RSI
s tisk nou t	PRSI
s tisk á v a t	PRSSSI
s tlač en í	PRSI
s tlač i t	PRSI
s tlač ova t	PRSI
s tlouc i	PRI
s tlouk a t	PRSI
stl á t	RSI
s tmel i t	PRSI
s tmel ova t	PRSI
stol ek	RI
stol eček	RS
stol n í	RSI
ston a t	RSI
stop ař i t	RSSI
stop nou t	RSI
stop ova t	RSI
stoup a t	RSI
stoup nou t	RSI
s toč en í	PRSI
s toč i t	PRSI
strach ova t	RSI
stran a	RI
stran ou	RS
s trav iteln ý	PRRI
s trav ová n í	PRSSS
straš i dl o	RSSI
straš i t	RSI
straš liv ý	RSI
straš n ý	RSI
straš n ě	RSI
s tref i t	PRSI
strejd a	RI
strejč k ova t	RSSI
stres	R
s trh a t	PRSI
s trh nou t	PRSI
s trh ova t	PRSI
s trh á v a t	PRSSSI
strk a t	RSI
strk á n í	RSSS
s tr nou t	PRSI
s tr nu t í	PRSSI
stroj	R
stroj ek	RI
stroj i t	RSI
strouh a n k a	RSSSI
strouh a t	RSI
s trp ě t	PRSI
strán k a	RSI
strán k ova t	RSSI
s tráv i t	PRSI
stráž i t	RSI
stráž ník	RS
stráž n ý	RSI
strýc	R
strýč ek	RI
strč i t	RSI
s trž i t	PRSI
stud en ý	RSI
stud i t	RSI
stud i um	RSI
stud ova t	RSI
s tul i t	PRSI
stup eň	RI
stup n ic e	RSSI
stup ň ova t	RSSI
stup ň ová n í	RSSSS
stup ň ov ý	RSSI
s tvoř en í	PRSI
s tvoř i t	PRSI
s tvrd i t	PRSI
s tvrz ova t	PRSI
styd l iv ě	RSSI
styd nou t	RSI
styl	R
styl iz ova t	RSSI
s táh nou t	PRSI
stár nou t	RSI
stá t	RI
stát n í	RSI
stá v k ova t	RSSSI
s táč e t	PRSI
s téc i	PRI
stíh a t	RSI
stín i t	RSI
stín ova t	RSI
s tísn i t	PRSI
s tísn ěn ý	PRSI
stěh ova t	RSI
s těsn a t	PRSI
s těsn á v a t	PRSSSI
střech a	RI
střed	R
střed a	RI
střed em	RS
střed isk o	RSI
střed n ě	RSI
střel ec	RI
střel ec k ý	RSSI
střel i t	RSI
střel n ic e	RSSI
s třep a t	PRSI
s třep á v a t	PRSSSI
střež i t	RSI
střih a t	RSI
střiž na	RI
střád a t	RSI
s třás a t	PRSI
s třás t	PRI
stříd a t	RSI
střík a t	RSI
střík nou t	RSI
stříl e t	RSI
such o	RI
such ý	RI
super špič k ov ý	PRSSI
suš en ý	RSI
suš i t	RSI
s val i t	PRSI
svat ost	RS
svat ouš k ova t	RSSSI
svat ý	RI
s vaz ova t	PRSI
svač i t	RSI
s vař i t	PRSI
s vař ova t	PRSI
s vlaž i t	PRSI
s vléc i	PRI
s vlék a t	PRSI
s vlék nou t	PRSI
s vlík a t	PRSI
svobod n ý	RSI
s vol a t	PRSI
s vol ova t	PRSI
s vol á v á n í	PRSSSSS
s voz i t	PRSI
s vrh nou t	PRSI
s vrh ova t	PRSI
s vrh á v a t	PRSSSI
s vál e t	PRSI
s vá t	PRI
svát ek	RI
svát eč n í	RSSI
s váz a t	PRSI
s váž e t	PRSI
s véz t	PRI
s vír a t	PRSI
svít a t	RSI
svít i t	RSI
s věs i t	PRSI
svět	R
svět ec	RI
svět eln ý	RSI
svět i t	RSI
svět l a t	RSSI
svět l e t	RSSI
svět l ý	RSI
svět él k ova t	RSSSI
svět ýl k o	RSSI
s věř i t	PRSI
s věř ova t	PRSI
s věš ova t	PRSI
syk a t	RSI
syk nou t	RSI
symbol	R
syn	R
syn chron iz ova t	RRSSI
syn ek	RI
syn ov stv í	RSSS
syn áček	RS
syp a t	RSI
system at ic k y	RSSSI
system iz ova t	RSSI
systém	R
syt i t	RSI
syč e t	RSI
syč ák	RS
sádr ova t	RSI
sáh nou t	RSI
sáh ova t	RSI
sák nou t	RSI
sál a t	RSI
sá t	RI
sídl i t	RSI
sídl o	RI
síl a	RI
sír a	RI
sír ov ý	RSI
síť	R
síť k ova t	RSSI
síť ova t	RSI
s čes a t	PRSI
s čes á v a t	PRSSSI
s čuch nou t	PRSI
s řez a t	PRSI
s řez á v a t	PRSSSI
s žeh nou t	PRSI
s ží v a t	PRSSI
tah a t	RSI
taj n ý	RSI
takt ova t	RSI
tanc ova t	RSI
tank ova t	RSI
tat ínek	RS
tav i t	RSI
taž en ý	RSI
techn ik	RS
tem ný	RS
tem n ě n ý	RSSSI
ten c e	RSI
ten č i t	RSSI
tep a t	RSI
tes a t	RSI
tesk n i t	RSSI
tesk n o	RSI
tesk n ot a	RSSI
test	R
tet ičk a	RSI
tet ičč in	RSS
tet ova t	RSI
text	R
text ova t	RSI
tich nou t	RSI
tich o	RI
tich ý	RI
tik	R
tik a t	RSI
tisk	R
tisk a c í	RSSI
tisk nou t	RSI
titul ova t	RSI
tiš e	RI
tiš i t	RSI
tk a l c ova t	RSSSSI
tk nou t	RSI
tk á t	RSI
tk á ň	RSI
tlach a t	RSI
tlap a t	RSI
tlap k a t	RSSI
tlač en ic e	RSSI
tlač i t	RSI
tlač í tk o	RSRI
tlesk nou t	RSI
tloust nou t	RSI
tloušt ík	RS
tlum i t	RSI
tlumoč en í	RSI
tlumoč i t	RSI
tlust ý	RI
tlust ě	RI
tláp nou t	RSI
tm av ě t	RSSI
tmel i t	RSI
tm í t	RSI
total iz ova t	RSSI
touh a	RI
toul a t	RSI
touž en í	RSI
touž i t	RSI
toč i t	RSI
tramp ova t	RSI
tref i t	RSI
tref n ě	RSI
trest	R
trest a n ec	RSSI
trest a n ý	RSSI
trest a t	RSI
trest n ý	RSI
trh	R
trh an	RS
trh a t	RSI
trk a t	RSI
trk nou t	RSI
tr nou t	RSI
tr nu t í	RSSI
troub a	RI
trous i t	RSI
trp ě l iv ost	RSSSS
trp ě liv ý	RSSI
trp ě l iv ě	RSSSI
trp ě t	RSI
truhl ař i t	RSSI
truhl ář sk ý	RSSI
trumf nou t	RSI
trv a l e	RSSI
trv a nliv ost	RSSS
trv a t	RSI
trysk a t	RSI
trysk nou t	RSI
tráp en í	RSI
tráp i t	RSI
tráv a	RI
tráv i t	RSI
trén ink	RS
trýzeň	R
trýzn i t	RSI
trž n í	RSI
tuch nou t	RSI
tuh nou t	RSI
tuh ost	RS
tul i t	RSI
tul ák	RS
tunel ova t	RSI
tup i t	RSI
tup ě	RI
tup ě t	RSI
tu zem sk o	PRSI
tuč n ě t	RSSI
tuš en í	RSI
tuš i t	RSI
tuš íc í	RSI
tuž i t	RSI
tvar ova t	RSI
tvor b a	RSI
tvoř en í	RSI
tvoř i t	RSI
tvrd i t	RSI
tvrd nou t	RSI
tvrd ý	RI
tvrz en í	RSI
tvář	R
typ	R
typ iz ova t	RSSI
tyč	R
tyč i t	RSI
tábor	R
táboř i t	RSI
táh nou t	RSI
tá t	RI
tát a	RI
tát ův	RI
táz a t	RSI
tíseň	R
tísn i t	RSI
tísn iv ý	RSI
tíž	R
tíž i t	RSI
týr á n í	RSSS
těk a t	RSI
těl es o	RSI
těl n at ě t	RSSSI
těl o	RI
těsn a t	RSI
těsn ý	RI
těš en í	RSI
těš i t	RSI
těž c e	RSI
těž i t	RSI
těž k o	RSI
těž k ý	RSI
třep i t	RSI
třep ot a t	RSSI
třes ou c í	RSSI
třešt i t	RSI
třás t	RI
tříd a	RI
tříd i t	RSI
tříd i čk a	RSSI
třísk a t	RSI
třísk nou t	RSI
u bal i t	PRSI
u bedn i t	PRSI
u bliž ova t	PRSI
u bod a t	PRSI
u brous i t	PRSI
u brzd i t	PRSI
u brán i t	PRSI
u by t ová n í	PRSSSS
u bý t	PRI
u bý v a t	PRSSI
u běh a t	PRSI
u ced i t	PRSI
u checht a t	PRSI
u checht á v a t	PRSSSI
u chod i t	PPPI
u chop i t	PRSI
u chov a t	PRSI
u chov á n í	PRSSS
u chov á v a t	PRSSSI
u chrán i t	PRSI
u chyl ova t	PRSI
u chyst a t	PRSI
u chyt i t	PRSI
u chyt nou t	PRSI
u chýl i t	PRSI
u cour a t	PRSI
u couv nou t	PRSI
u cp á v a t	PRSSSI
u ct i v ě	PRSSI
u ct í t	PRSI
u ct í v á n í	PRSSSSS
u cuc á v a t	PRSSSI
u cuk nou t	PRSI
u cuk á v a t	PRSSSI
u cít i t	PRSI
ud i t	RSI
u drob i t	PRSI
u drol i t	PRSI
u drž e n í	PRSSI
u drž i teln ý	PRSSI
u drž ova n ý	PRSSI
u drž ova t	PRSI
u dup a t	PRSI
u dup á v a t	PRSSSI
u dus i t	PRSI
u dus á v a t	PRSSSI
u dáv i t	PRSI
u díl e t	PRSI
u dých a n ý	PRSSI
u dých a t	PRSI
u děl a t	PRSI
u děl i t	PRSI
u děl á n í	PRSSS
u dř í t	PRSI
u fik nou t	PRSI
u fouk nou t	PRSI
u has i t	PRSI
u has ín a t	PRSSI
uhel n at ě t	RSSSI
u hlaz ova t	PRSI
u hled a t	PRSI
u hlod a t	PRSI
uhl í	RS
u hlíd a t	PRSI
u hmat a t	PRSI
u hnizď ova t	PRSI
u hní t	PRI
u hní v a t	PRSSI
u hnízd i t	PRSI
u hobl ova t	PRSI
u hod i t	PRSI
u host i t	PRSI
u hoz en ost	PRSS
u hoz en ý	PRSI
u hrab a t	PRSI
u hrab á v a t	PRSSSI
u hrad i t	PRSI
u hraz ova t	PRSI
u hryz a t	PRSI
u hryz nou t	PRSI
u hryz á v a t	PRSSSI
u hrá t	PRI
u háj i t	PRSI
u háč k ova t	PRSSI
u hýb a t	PRSI
u jas n i t	PRSSI
u jas ň ova t	PRSSI
u jedn á v a t	PRSSSI
u je t	PRI
u jezd i t	PRSI
u jišť ova t	PRSI
u jíd a t	PRSI
u jím a t	PRSI
u jí t	PRI
u jížd ě t	PRSI
u kamen ová v a t	PRSSSI
u kap á v a t	PRSSSI
u kaz ova t	PRSI
u kec a t	PRSI
u klid i t	PRSI
u klid n i t	PRSSI
u klid ň ova t	PRSSI
u klid ň uj íc í	PRSSSI
u klon i t	PRSI
u klov nou t	PRSI
u klán ě t	PRSI
u klíz e t	PRSI
u koj i t	PRSI
u koj ova t	PRSI
u koléb a t	PRSI
u konejš i t	PRSI
u konejš ova t	PRSI
u konč i t	PRSI
u konč ova t	PRSI
u kop a t	PRSI
u kop nou t	PRSI
u kous a t	PRSI
u kous nou t	PRSI
u kous nu t í	PRSSI
u kořist i t	PRSI
u krad en í	PRSI
u krad en ý	PRSI
u krot i t	PRSI
u krout i t	PRSI
u krád a t	PRSI
u kráj e t	PRSI
u krás t	PRI
u krý t	PRI
u krý v a t	PRSSI
u kus ova t	PRSI
u kut i t	PRSI
u kvap en ý	PRSI
u kvap i t	PRSI
u kvap ova t	PRSI
u káj e t	PRSI
u káp nou t	PRSI
u káz a t	PRSI
u křič e t	PRSI
u křiž ova t	PRSI
u lek nou t	PRSI
u let ova t	PRSI
u let ě t	PRSI
ulic e	RI
u liz ova t	PRSI
ulič n ík	RSS
u loup en í	PRSI
u loup nou t	PRSI
u lož en í	PRSI
u lož i t	PRSI
u lám a t	PRSI
u lét a t	PRSI
u lét á v a t	PRSSSI
u lé v a t	PRSSI
u líb a t	PRSI
u lí t	PRI
u lít á v a t	PRSSSI
u líz a t	PRSI
u líz nou t	PRSI
u maz a t	PRSI
u mačk a t	PRSI
u mdl é v a t	PRSSSI
u mdl í t	PRSI
u mdl í v a t	PRSSSI
u met á v a t	PRSSSI
u mix ova t	PRSI
u miň ova t	PRSI
u mlouv a t	PRSI
u mluv i t	PRSI
u ml í t	PRSI
u mlč e t	PRSI
u mlč ova t	PRSI
u moc n i t	PRSSI
u moc ň ova t	PRSSI
u modř i t	PRSI
u mok nou t	PRSI
u mot a t	PRSI
u mot á v a t	PRSSSI
u moř i t	PRSI
u moř ova t	PRSI
u mrav n i t	PRSSI
u mrav ň ova t	PRSSI
u mrtv i t	PRSI
u mrtv ova t	PRSI
u muč i t	PRSI
u máz nou t	PRSI
u máč e t	PRSI
u mích a t	PRSI
u mín i t	PRSI
u mír a t	PRSI
u míst i t	PRSI
u mý t	PRI
u mý v a t	PRSSI
um ě l e	RSSI
um ě l k ova t	RSSSSI
um ě n í	RSSI
um ě t	RSI
u nož i t	PRSI
u nud i t	PRSI
u náš e t	PRSI
u pad a t	PRSI
u pad á v a t	PRSSSI
u pal ova t	PRSI
u pamat ova t	PRSI
u pamat ová v a t	PRSSSI
u patl a t	PRSI
u paž i t	PRSI
u paž ova t	PRSI
u pevn i t	PRSI
u pevn ěn í	PRSI
u pil ova t	PRSI
u pis ova t	PRSI
u pis ova tel	PRSS
u plak a t	PRSI
u plav a t	PRSI
u pliv a t	PRSI
u pliv nou t	PRSI
u pliv ova t	PRSI
u pliv á v a t	PRSSSI
u ply nou t	PRSI
u plác a t	PRSI
u plác e t	PRSI
u plác á v a t	PRSSSI
u plét a t	PRSI
u plý v a t	PRSSI
u pot i t	PRSI
u po třeb i t	PPRSI
u pout a t	PRSI
u pout á v a t	PRSSSI
u poušt ě t	PRSI
u po zor n i t	PPRSSI
u po zor ň ova t	PPRSSI
u prac ova t	PRSI
u prav en ý	PRSI
u prav i t	PRSI
u prav ova t	PRSI
u praž en í	PRSI
u prch nou t	PRSI
u proš ova t	PRSI
u práš i t	PRSI
u ps a t	PRSI
u pust i t	PRSI
u pál i t	PRSI
u péc i	PRI
u pích nou t	PRSI
u pín a č	PRSS
u pěch ova t	PRSI
u přesn i t	PRSI
u přesň ova t	PRSI
u přím n ost	PRSS
u přís t	PRI
u rad i t	PRSI
u rob i t	PRSI
u rod i t	PRSI
u rv a t	PRSI
u rychl i t	PRSI
u rychl ova t	PRSI
u rychl ová n í	PRSSS
u ráž k a	PRSI
u rýp nou t	PRSI
u rý t	PRI
u sch nou t	PRSI
u s chov a t	PPRSI
u s chov á v a t	PPRSSSI
u sek a t	PRSI
u sek nou t	PRSI
u sek á v a t	PRSSSI
u sidl ova t	PRSI
u s jedn ot i t	PPRRSI
u skuteč n i t	PRSSI
u skuteč n ěn í	PRSSI
u skuteč ň ova t	PRSSI
u skuteč ň ová n í	PRSSSS
u skříp l e	PRSI
u slin i t	PRSI
u smaž i t	PRSI
u s mlouv a t	PPRSI
u s mr c ova t	PPRSSI
u s mr c uj íc í	PPRSSSI
u s mr t i t	PPRSSI
u s mysl e t	PPRSI
u smí v a t	PRSSI
u s náš e t	PPRSI
u s nés t	PPRI
u soud i t	PRSI
u s plav n i t	PPRSSI
u s plav ň ova t	PPRSSI
u spoř i t	PRSI
u sp á v a t	PRSSSI
u spě t	PRI
u srk nou t	PRSI
u srk á v a t	PRSSSI
u star a t	PRSI
u sta t	PRI
u stl a t	PRSI
u stoup i t	PRSI
u straš i t	PRSI
u s tr nu l e	PPRSSI
u stroj i t	PRSI
u strouh a t	PRSI
u stup ova t	PRSI
u stá n í	PRSI
u stá t	PRI
u střel i t	PRSI
u střád a t	PRSI
u suš i t	PRSI
u sych a t	PRSI
u syp a t	PRSI
u syp á v a t	PRSSSI
u sídl i t	PRSI
u sín a t	PRSI
u sýp a t	PRSI
u tah a t	PRSI
u tah ova t	PRSI
u taj ova t	PRSI
u tanc ova t	PRSI
u tanč i t	PRSI
u tisk ova t	PRSI
u tiš i t	PRSI
u tiš ova t	PRSI
u tk a t	PRSI
u tk á v a t	PRSSSI
u tlač ova t	PRSI
u tlouc i	PRI
u tlouk a t	PRSI
u tlum i t	PRSI
u trh a t	PRSI
u trh nou t	PRSI
u trh ova t	PRSI
u trous i t	PRSI
u trp e n í	PRSSS
u trp ě t	PRSI
u trác e t	PRSI
u tráp i t	PRSI
u trýzn i t	PRSI
u trž i t	PRSI
u tuch nou t	PRSI
u tuh nou t	PRSI
u tuž i t	PRSI
u tvoř i t	PRSI
u tvrd nou t	PRSI
u tvrz ova t	PRSI
u tvář en í	PRSI
u táboř i t	PRSI
u táh nou t	PRSI
u téc i	PRI
u tík a t	PRSI
u tír a t	PRSI
u týr a t	PRSI
u těsň ova t	PRSI
u těš en ý	PRSI
u těš i t	PRSI
u těš ova t	PRSI
u těš uj íc í	PRSSI
u tř í t	PRSI
u vad nou t	PRSI
u val i t	PRSI
u val ova t	PRSI
u var ova t	PRSI
u vaz ova t	PRSI
u vař i t	PRSI
u veleb i t	PRSI
u veleb ova t	PRSI
u vol i t	PRSI
u vol n i t	PRSSI
u vol n ěn í	PRSSI
u vol ova t	PRSI
u vol ň ova t	PRSSI
u vrh nou t	PRSI
u vrh ova t	PRSI
u vrt a t	PRSI
u vál e t	PRSI
u váz a t	PRSI
u váz nou t	PRSI
u véz t	PRI
u víj e t	PRSI
u ví t	PRI
u vít a t	PRSI
u vít á n í	PRSSS
u víz nou t	PRSI
u věz n i t	PRSSI
u věř i t	PRSI
u za mk nou t	PPRSI
u za vír a t	PPRSI
u za vř e n í	PPRSSI
u zdrav en í	PRSI
u zdrav i t	PRSI
u zdrav ova t	PRSI
u zdvih nou t	PRSI
uz en ý	RSI
u zl ob i t	PRSSI
u znam en a t	PRSSI
u zn á n í	PRSSS
u zn á v á n í	PRSSSSS
u zouf a t	PRSI
u zrá t	PRI
u zrá v a t	PRSSI
uč eb n ic e	RSSSI
uč en ec	RSI
uč en í	RSI
u čes a t	PRSI
u čin i t	PRSI
u čin ěn ý	PRSI
uč i tel ova t	RSSSI
u člen i t	PRSI
u čoud i t	PRSI
u řeht a t	PRSI
u řek nou t	PRSI
u řez á v a t	PRSSSI
u říd i t	PRSI
u řít i t	PRSI
u říz nou t	PRSI
u škod i t	PRSI
u škrt i t	PRSI
u škub nou t	PRSI
u škvař i t	PRSI
u šlap ova t	PRSI
u šlap á v a t	PRSSSI
u šlecht i l ost	PRSSS
u šleh a t	PRSI
u šláp nou t	PRSI
u š l ý	PPPI
u šmudl a t	PRSI
u šoup a t	PRSI
u špin i t	PRSI
u šplích nou t	PRSI
u štv a t	PRSI
u štíp nou t	PRSI
u štíp á v a t	PRSSSI
u štěk a t	PRSI
u ší t	PRI
u žmol i t	PRSI
u žvýk a t	PRSI
vad i t	RSI
valch ova t	RSI
val n ý	RSI
vandr ova t	RSI
vandr ov n í	RSSI
vandr ák	RS
va nou t	RSI
varhan y	RI
var ova t	RSI
vař i t	RSI
v cház e t	PPPI
v ciť ova t	PRSI
v cuc nu t í	PRSSI
v cít i t	PRSI
v dech nou t	PRSI
v dech ova t	PRSI
ve jí t	PRI
veleb i t	RSI
vel e t	RSI
ve mlouv a t	PRSI
ve mluv i t	PRSI
ven k ov an	RSSS
ven k u	RSI
ven č i t	RSSI
verb ova t	RSI
ves	R
vesel e	RI
vesel ost	RS
vesel ý	RI
vesl ař	RS
vesl ova t	RSI
ves nic e	RSI
ve tk nou t	PRSI
ve tř í t	PRSI
ve val i t	PRSI
ve zd í t	PRSI
večeř e t	RSI
v haz ova t	PRSI
v hod i t	PRSI
v hop k a t	PRRSI
v hrk nou t	PRSI
v hr nou t	PRSI
vibr ova t	RSI
vid iteln ý	RRI
vid ova t	RSI
vid ě n í	RSSI
vikl a t	RSI
vin i t	RSI
vis e t	RSI
viz ova t	RSI
v je t	PRI
v jížd ě t	PRSI
v kap a t	PRSI
v klouz a t	PRSI
v klouz nou t	PRSI
v klouz á v a t	PRSSSI
v klád a t	PRSI
v kop nou t	PRSI
v koul e t	PRSI
v kořen i t	PRSI
v krád a t	PRSI
vlad ař i t	RSSI
vlas	R
vlast	R
vlast n i t	RSSI
vlast n í	RSI
vlast n ě	RSI
v let ě t	PRSI
vlh c e	RSI
vlh k o	RSI
vlh č i t	RSSI
v lichoc ova t	PRSI
v lichot i t	PRSI
v lis ova t	PRSI
vlk	R
vln a	RI
vln i t	RSI
v loud i t	PRSI
v loud ěn í	PRSI
v loup a t	PRSI
v lož i t	PRSI
v lož k a	PRSI
v lož k ova c í	PRSSSI
vlád nou t	RSI
v lák a t	PRSI
vlás ek	RI
vlá t	RI
vláč n ý	RSI
vléc i	RI
v lét a t	PRSI
v lét á v a t	PRSSSI
v lé v a t	PRSSI
v léz a t	PRSI
v léz t	PRI
v lí t	PRI
v lít a t	PRSI
vlč ek	RI
v mačk a t	PRSI
v mont ova t	PRSI
v mysl e t	PRSI
v mích a t	PRSI
v mýšl e t	PRSI
v noř i t	PRSI
v nuc ova t	PRSI
v nut i t	PRSI
v náš e t	PRSI
v nés t	PRI
v ním a t	PRSI
v ním a teln ý	PRSSI
v ním a tel sk ý	PRSSSI
v ním á n í	PRSSS
vod a	RI
vod n at ě t	RSSSI
vod nés t	PRI
vod ní	RS
vod n ík	RSS
vol a t	RSI
vol i t	RSI
vol n ost	RSS
vol n í	RSI
vol n ý	RSI
vol n ě	RSI
vol á n í	RSSS
voz i t	RSI
voz ovk a	RSI
v pad a t	PRSI
v pad á v a t	PRSSSI
v pal ova t	PRSI
v paš ova t	PRSI
v pich ova t	PRSI
v plat i t	PRSI
v plíž i t	PRSI
v poušt ě t	PRSI
v prav i t	PRSI
v pump ova t	PRSI
v pust i t	PRSI
v pál i t	PRSI
v páč i t	PRSI
v pích a t	PRSI
v pích nou t	PRSI
v pích á v a t	PRSSSI
vrac e n í	RSSI
vrac e t	RSI
v raz i t	PRSI
vrch n í	RSS
vrch ol i t	RSSI
vrh a t	RSI
vrk a t	RSI
v roub i t	PRSI
v roub k ova t	PRSSI
vrstv a	RI
vrstv i t	RSI
vrt a t	RSI
vrt nou t	RSI
vrt á n í	RSSS
vrt ě t	RSI
v rub ova t	PRSI
vrz nou t	RSI
vrás k a	RSI
vrát i t	RSI
vrávor a t	RSI
v ráž e n í	PRSSI
v ráž e t	PRSI
v rýp nou t	PRSI
v rý t	PRI
v rý v a t	PRSSI
vrč e t	RSI
vrš ek	RI
v růst a t	PRSI
vrž en ý	RSI
v skoč i t	PRSI
v sol i t	PRSI
v srk nou t	PRSI
v strč i t	PRSI
v stup ova t	PRSI
v stá t	PRI
v stá v a t	PRSSI
v střel i t	PRSI
v střik ova t	PRSI
v střík nou t	PRSI
v syp a t	PRSI
v syp á v a t	PRSSSI
v sá t	PRI
v sá v a t	PRSSI
v sít i t	PRSI
v tah ova t	PRSI
v tes a t	PRSI
vtip k ova t	RSSI
v tisk a t	PRSI
v tisk nou t	PRSI
v tisk á v a t	PRSSSI
v tlač i t	PRSI
v tlač ova t	PRSI
v tlouc i	PRI
v trh ova t	PRSI
v trž en ý	PRSI
v táh nou t	PRSI
v téc i	PRI
v ték a t	PRSI
v těl i t	PRSI
v těl ova t	PRSI
v těsn a t	PRSI
v těsn á v a t	PRSSSI
vulkan iz ova t	RSSI
vy babr a t	PRSI
vy baf a t	PRSI
vy bagr ova t	PRSI
vy bal i t	PRSI
vy bal ova t	PRSI
vy barv ova t	PRSI
vy bav en í	PRSI
vy bav en ý	PRSI
vy bav ova t	PRSI
vy bedn i t	PRSI
vy belh a t	PRSI
vy beton ova t	PRSI
vy blejsk nou t	PRSI
vy blázn i t	PRSI
vy blí t	PRI
vy blýsk a t	PRSI
vy bod ova t	PRSI
vy boj ova t	PRSI
vy boj ová v a t	PRSSSI
vy bouch nou t	PRSI
vy bour a t	PRSI
vy bouř i t	PRSI
vy boč i t	PRSI
vy boč ova t	PRSI
vy brod i t	PRSI
vy brous i t	PRSI
vy bruš ova t	PRSI
vy brynd a t	PRSI
vy bubn ova t	PRSI
vy buch ova t	PRSI
vy bud ova t	PRSI
vy buj e t	PRSI
vy bád a t	PRSI
vy básn i t	PRSI
vy bíl i t	PRSI
vy bý t	PRI
vy bý v a t	PRSSI
vy běh a t	PRSI
vy běh á v a t	PRSSSI
vy běl e t	PRSI
vy běl i t	PRSI
vy ced i t	PRSI
vy cement ova t	PRSI
vy cen i t	PRSI
vy ceň ova t	PRSI
vy chcíp a t	PRSI
vy chlad i t	PRSI
vy chlad nou t	PRSI
vy chlast a t	PRSI
vy chlaz ova t	PRSI
vy chov a t	PRSI
vy chov á v a c í	PRSSSSI
vy chov á v a t	PRSSSI
vy chrchl a t	PRSI
vy chrchl á v a t	PRSSSI
vy chut n á v a t	PRSSSSI
vy chval ova t	PRSI
vy chvál i t	PRSI
vy chvě t	PRI
vy chyl ova t	PRSI
vy chyt a t	PRSI
vy chytr ač i t	PRSSI
vy chyt á v a t	PRSSSI
vy cház ej íc í	PPRSI
vy cház e t	PPPI
vy chýl i t	PRSI
vy cink a t	PRSI
vy ciť ova t	PRSI
vy cl í v a t	PRSSSI
vy cp a t	PRSI
vy cuc a t	PRSI
vy cuc á v a t	PRSSSI
vy cvič i t	PRSI
vy cvál a t	PRSI
vy cák nou t	PRSI
vy cít i t	PRSI
vy dař i t	PRSI
vy dech ova t	PRSI
vy dekor ova t	PRSI
vy dlab an ý	PRSI
vy dlab a t	PRSI
vy dlab á v a t	PRSSSI
vy dloub a t	PRSI
vy dloub nou t	PRSI
vy dloub á v a t	PRSSSI
vy dluž i t	PRSI
vy dlážd i t	PRSI
vy dm ou t	PRSI
vy do bý t	PPRI
vy do bý v a t	PPRSSI
vy doj ova t	PRSI
vy dol ova t	PRSI
vy dou t	PRI
vy dou v a t	PRSSI
vy dražď ova t	PRSI
vy drb a t	PRSI
vy drh nou t	PRSI
vy drob i t	PRSI
vy drol i t	PRSI
vy drol ova t	PRSI
vy dráp a t	PRSI
vy dráp nou t	PRSI
vy drát k ova t	PRSSI
vy dráž k ova t	PRSSI
vy drž e t	PRSI
vy drž ova t	PRSI
vy dum a t	PRSI
vy dup a t	PRSI
vy dup á v a t	PRSSSI
vy dáv i t	PRSI
vy dír a t	PRSI
vy dých a t	PRSI
vy děd i t	PRSI
vy děl ova t	PRSI
vy děl á v a t	PRSSSI
vy děr a č n ost	PRSSSS
vy děr ova t	PRSI
vy děs i t	PRSI
vy dř í t	PRSI
vy fint i t	PRSI
vy flák nou t	PRSI
vy fot i t	PRSI
vy fouk á v a t	PRSSSI
vy fuk ova t	PRSI
vy fár a t	PRSI
vy has i t	PRSI
vy has nou t	PRSI
vy has ín a t	PRSSI
vy hek nou t	PRSI
vy hlad i t	PRSI
vy hlad ov ova t	PRSSI
vy hlad ov ě t	PRSSI
vy hlaz ova t	PRSI
vy hlaš ova t	PRSI
vy hled á v a t	PRSSSI
vy hled ě t	PRSI
vy hlod a t	PRSI
vy hlod á v a t	PRSSSI
vy hloub a t	PRSI
vy hloub i t	PRSI
vy hlub ova t	PRSI
vy hlás i t	PRSI
vy hláš en í	PRSI
vy hlíd a t	PRSI
vy hmát nou t	PRSI
vy hn a t	PRSI
vy hnoj i t	PRSI
vy hnís t	PRI
vy hní t	PRI
vy hní v a t	PRSSI
vy hobl ova t	PRSI
vy hoj i t	PRSI
vy hol i t	PRSI
vy hop k a t	PRRSI
vy hop k ova t	PRRSI
vy host i t	PRSI
vy hotov i t	PRSI
vy hotov ova t	PRSI
vy hošť ova t	PRSI
vy hrad i t	PRSI
vy hraz ova t	PRSI
vy hrk nou t	PRSI
vy hr nou t	PRSI
vy hroc ova t	PRSI
vy hrot i t	PRSI
vy hrož ova t	PRSI
vy hryz a t	PRSI
vy hryz nou t	PRSI
vy hráb nou t	PRSI
vy hrá t	PRI
vy hrá v a t	PRSSI
vy hub i t	PRSI
vy hub nou t	PRSI
vy hák ova t	PRSI
vy hán ě t	PRSI
vy ház e t	PRSI
vy háč k ova t	PRSSI
vy hýb a t	PRSI
vy hýb a v ě	PRSSI
vy hřá t	PRI
vy hří v a t	PRSSI
vy jas n i t	PRSSI
vy jas n ěn ý	PRSSI
vy jas ň ova t	PRSSI
vy jedn a t	PRSI
vy jedn ot i t	PRRSI
vy jedn á v á n í	PRSSSSS
vy je t	PRI
vy jev i t	PRSI
vy jezd i t	PRSI
vy jíd a t	PRSI
vy jím a t	PRSI
vy jížd ě t	PRSI
vy kachl ík ova t	PRSSI
vy kal i t	PRSI
vy kap a t	PRSI
vy kap á v a t	PRSSSI
vy kartáč ova t	PRSI
vy kas a t	PRSI
vy kaz ova t	PRSI
vy kašl a t	PRSI
vy kašl á v a t	PRSSSI
vy kec a t	PRSI
vy klep a t	PRSI
vy klep nou t	PRSI
vy klep á v a t	PRSSSI
vy klest i t	PRSI
vy klesť ova t	PRSI
vy klešť ova t	PRSI
vy klid i t	PRSI
vy kliz ova t	PRSI
vy klič k ova t	PRSSI
vy klon i t	PRSI
vy klop i t	PRSI
vy klop ova t	PRSI
vy klopýt a t	PRSI
vy kloub i t	PRSI
vy klouz a t	PRSI
vy klouz nou t	PRSI
vy klouz á v a t	PRSSSI
vy klov a t	PRSI
vy klub a t	PRSI
vy klán ě t	PRSI
vy kláp ě t	PRSI
vy klíz e t	PRSI
vy klíč i t	PRSI
vy kokt a t	PRSI
vy koled ova t	PRSI
vy kolíb a t	PRSI
vy kol ík ova t	PRSSI
vy kol íč k ova t	PRSSSI
vy kombin ova t	PRSI
vy kon a t	PRSI
vy kon á v a t	PRSSSI
vy kon á v á n í	PRSSSSS
vy kop a t	PRSI
vy kop nou t	PRSI
vy kop á v a t	PRSSSI
vy kost i t	PRSI
vy kosť ova t	PRSI
vy kouk a t	PRSI
vy kouk nou t	PRSI
vy koup a t	PRSI
vy koup en í	PRSI
vy koup i t	PRSI
vy kous nou t	PRSI
vy kouzl i t	PRSI
vy kouř i t	PRSI
vy kořen i t	PRSI
vy kořist i t	PRSI
vy kořisť ova t	PRSI
vy kraj ova t	PRSI
vy kraš l ova t	PRSSI
vy krm i t	PRSI
vy krm ova t	PRSI
vy kroj i t	PRSI
vy kroj ova t	PRSI
vy krout i t	PRSI
vy kruž ova t	PRSI
vy krv ác e t	PRSSI
vy krystal iz ova t	PRSSI
vy kráj e t	PRSI
vy kráš l i t	PRSSI
vy krý t	PRI
vy krý v a t	PRSSI
vy kuch a t	PRSI
vy kuk ova t	PRSI
vy kus ova t	PRSI
vy kut a t	PRSI
vy kutál en ý	PRSI
vy kutál e t	PRSI
vy kut á v a t	PRSSSI
vy kuř ova t	PRSI
vy kvas i t	PRSI
vy kvét a t	PRSI
vy kyd a t	PRSI
vy kyp ě t	PRSI
vy kác e t	PRSI
vy kál e t	PRSI
vy káz a t	PRSI
vy křik nou t	PRSI
vy křik ova t	PRSI
vy lad i t	PRSI
vy lam ova t	PRSI
vy laď ova t	PRSI
vy lek a t	PRSI
vy let ě t	PRSI
vy lešt i t	PRSI
vy lh a t	PRSI
vy lis ova t	PRSI
vy liz ova t	PRSI
vy lič ova t	PRSI
vy loud a t	PRSI
vy loud i t	PRSI
vy loup a t	PRSI
vy loup i t	PRSI
vy loup nou t	PRSI
vy loup nu t ý	PRSSI
vy loup á v a t	PRSSSI
vy lousk a t	PRSI
vy lousk nou t	PRSI
vy louč en í	PRSI
vy louž i t	PRSI
vy lov i t	PRSI
vy lož i t	PRSI
vy lup ova t	PRSI
vy luz ova t	PRSI
vy luč ova t	PRSI
vy lušt i t	PRSI
vy lák a t	PRSI
vy lám a t	PRSI
vy lét a t	PRSI
vy lét á v a t	PRSSSI
vy lé v a t	PRSSI
vy léč i t	PRSI
vy lín a t	PRSI
vy lí t	PRI
vy lít a t	PRSI
vy lít nou t	PRSI
vy lít á v a t	PRSSSI
vy lí v a t	PRSSI
vy líz a t	PRSI
vy líz nou t	PRSI
vy líz á v a t	PRSSSI
vy líč i t	PRSI
vy mal ova t	PRSI
vy manévr ova t	PRSI
vy mast i t	PRSI
vy mas ír ova t	PRSSI
vy maz a t	PRSI
vy mačk a t	PRSI
vy met a t	PRSI
vy mez n ík ova t	PRSSSI
vy miz e t	PRSI
vy miň ova t	PRSI
vy mk nou t	PRSI
vy mluv i t	PRSI
vy mlát i t	PRSI
vy ml í t	PRSI
vy moc i	PRI
vy model ova t	PRSI
vy modl i t	PRSI
vy mont ova t	PRSI
vy mot a t	PRSI
vy mot á v a t	PRSSSI
vy moř i t	PRSI
vy mrsk a t	PRSI
vy mrsk nou t	PRSI
vy mršt i t	PRSI
vy myc ova t	PRSI
vy myk a t	PRSI
vy mysl e t	PRSI
vy mysl i t	PRSI
vy máh a t	PRSI
vy máh á n í	PRSSS
vy mám i t	PRSI
vy máz nou t	PRSI
vy máč e t	PRSI
vy mín i t	PRSI
vy mý t	PRI
vy mýt a t	PRSI
vy mýt i t	PRSI
vy mýšl e t	PRSI
vy měn i t	PRSI
vy měň ova t	PRSI
vy měř i t	PRSI
vy mř í t	PRSI
vy na chvál i t	PPRSI
vy na hrad i t	PPRSI
vy na hraz ova t	PPRSI
vy na léz a t	PPRSI
vy na léz t	PPRI
vy na léz á n í	PPRSSS
vy nech a t	PRSI
vy nech á v a t	PRSSSI
vy noř i t	PRSI
vy noř ova t	PRSI
vy nuc en ý	PRSI
vy nuc ova t	PRSI
vy ná lez c ův	PPRSI
vy náš e n í	PRSSI
vy náš e t	PRSI
vy nés t	PRI
vy obc ova t	PRSI
vy oper ova t	PRSI
vy ostř i t	PRSI
vy ostř ova t	PRSI
vy pad nou t	PRSI
vy pad á v a t	PRSSSI
vy pancéř ova t	PRSI
vy parád i t	PRSI
vy pař i t	PRSI
vy pař ova t	PRSI
vy pich ova t	PRSI
vy pil ova n ě	PRSSI
vy pil ova t	PRSI
vy pipl a t	PRSI
vy pis ova t	PRSI
vy pj at ý	PRSI
vy plak a t	PRSI
vy plat i t	PRSI
vy plav ová n í	PRSSS
vy plaz i t	PRSI
vy plaz ova t	PRSI
vy plaš i t	PRSI
vy plen i t	PRSI
vy pliv a t	PRSI
vy pliv nou t	PRSI
vy pliv á v a t	PRSSSI
vy pln i t	PRSI
vy pln ěn í	PRSI
vy pln ěn ý	PRSI
vy ply nou t	PRSI
vy plác e t	PRSI
vy plét a t	PRSI
vy plí t	PRI
vy plíž i t	PRSI
vy plýtv a t	PRSI
vy plň ová n í	PRSSS
vy plň uj íc í	PRSSI
vy po klon k ova t	PPRSSI
vy po máh a t	PPRSI
vy portrét ova t	PRSI
vy po třeb ova t	PPRSI
vy poušt ě t	PRSI
vy po víd a t	PPRSI
vy po věd ě t	PPRSI
vy po zor ova t	PPRSI
vy po řád a t	PPRSI
vy prac ova t	PRSI
vy prac ová n í	PRSSS
vy prac ová v a t	PRSSSI
vy pr a t	PRSI
vy prav i t	PRSI
vy prav ova t	PRSI
vy prav ová n í	PRSSS
vy praž i t	PRSI
vy prch a t	PRSI
vy proš ova t	PRSI
vy prsk nou t	PRSI
vy pruž i t	PRSI
vy prásk a t	PRSI
vy práv ě t	PRSI
vy práš i t	PRSI
vy prš e t	PRSI
vy ps a t	PRSI
vy pt a t	PRSI
vy pud i t	PRSI
vy pump ova t	PRSI
vy pust i t	PRSI
vy puz ova t	PRSI
vy puč e t	PRSI
vy pušt ěn ý	PRSI
vy pál i t	PRSI
vy pár a t	PRSI
vy pás t	PRI
vy pátr a t	PRSI
vy páč i t	PRSI
vy péc i	PRI
vy pér ova t	PRSI
vy pích a t	PRSI
vy pích nou t	PRSI
vy pích á v a t	PRSSSI
vy pík a t	PRSI
vy pín a t	PRSI
vy pín ač	PRS
vy pír a t	PRSI
vy písk a t	PRSI
vy písk nou t	PRSI
vy pěst i t	PRSI
vy pěst ova t	PRSI
vy půjč i t	PRSI
vy půjč ova t	PRSI
vy rab ova t	PRSI
vy raz i t	PRSI
vy rob i t	PRSI
vy roj i t	PRSI
vy rub a t	PRSI
vy ruš i t	PRSI
vy ruš ova t	PRSI
vy rv a t	PRSI
vy ráb ě t	PRSI
vy ráž e t	PRSI
vy rýp a t	PRSI
vy rýp nou t	PRSI
vy rý t	PRI
vy rý v a t	PRSSI
vy sch nou t	PRSI
vy sed ě t	PRSI
vy sek a t	PRSI
vy sek nou t	PRSI
vy sidl ova t	PRSI
vy sil ova t	PRSI
vy skak ova t	PRSI
vy skoč i t	PRSI
vy skák a t	PRSI
vy sl a n ý	PRSSI
vy sl a t	PRSI
vy sled ova t	PRSI
vy slouž i l ý	PRSSI
vy slouž i t	PRSI
vy slyš e t	PRSI
vy sl á n í	PRSSS
vy slíd i t	PRSI
vy smaž i t	PRSI
vy smaž ova t	PRSI
vy smol i t	PRSI
vy smrk a t	PRSI
vy smí v a t	PRSSI
vys ok o	RSI
vys ok ý	RSI
vy sol i t	PRSI
vy sol ova t	PRSI
vy sond ova t	PRSI
vy soud i t	PRSI
vy souk a t	PRSI
vy souš e t	PRSI
vy sp a t	PRSI
vy spekul ova t	PRSI
vy s prav i t	PPRSI
vy spár ova t	PRSI
vy sp á v a t	PRSSSI
vy spě l ý	PRSI
vy sr a t	PRSI
vy srk nou t	PRSI
vy s ráž e t	PPRSI
vy sta v en ý	PRSSI
vy stač i t	PRSI
vy stih nou t	PRSI
vy stih ova t	PRSI
vy stl a t	PRSI
vy ston a t	PRSI
vy stop ova t	PRSI
vy straš i t	PRSI
vy stres ova t	PRSI
vy strk ova t	PRSI
vy strk á v a t	PRSSSI
vy stroj en ý	PRSI
vy stroj i t	PRSI
vy strč i t	PRSI
vy stud ova t	PRSI
vy stup ova t	PRSI
vy stup ň ova t	PRSSI
vy stěh ova t	PRSI
vy stěh ová v a t	PRSSSI
vy střel i t	PRSI
vy střel ova t	PRSI
vy stříd a t	PRSI
vy stříd á v a t	PRSSSI
vy střík a t	PRSI
vy střík nou t	PRSI
vy stříl e t	PRSI
vy suš i t	PRSI
vy suš ova t	PRSI
vy s vléc i	PPRI
vy s vlék a t	PPRSI
vy s vlék nou t	PPRSI
vy s vlík a t	PPRSI
vy svobod i t	PRSI
vy svoboz ova t	PRSI
vy svít i t	PRSI
vy svěc ova t	PRSI
vy svět i t	PRSI
vy syp a t	PRSI
vy syp á v a t	PRSSSI
vy sá t	PRI
vy sá v a t	PRSSI
vy sídl i t	PRSI
vy sídl uj íc í	PRSSI
vy síl a t	PRSI
vy síl i t	PRSI
vy síl á n í	PRSSS
vy síř i t	PRSI
vy sýp a t	PRSI
vy tah a t	PRSI
vy tah ova t	PRSI
vy tanc ova t	PRSI
vy tanč i t	PRSI
vy tep a t	PRSI
vy tes a t	PRSI
vy tes á v a t	PRSSSI
vy tisk nou t	PRSI
vy tišt ěn í	PRSI
vy tk nou t	PRSI
vy tlach a t	PRSI
vy tlač i t	PRSI
vy tlač ova t	PRSI
vy tlouc i	PRI
vy tlouk a t	PRSI
vy tm av i t	PRSSI
vy tmel i t	PRSI
vy t nou t	PPPI
vy touž en ý	PRSI
vy toč i t	PRSI
vy trac en ý	PRSI
vy trest a t	PRSI
vy trh a t	PRSI
vy trh nou t	PRSI
vy trh ova t	PRSI
vy trh á v a t	PRSSSI
vy troub i t	PRSI
vy trp ě t	PRSI
vy trv a l e	PRSSI
vy trv á v a t	PRSSSI
vy trysk nou t	PRSI
vy trysk ova t	PRSI
vy trác e t	PRSI
vy tráv i t	PRSI
vy trž en í	PRSI
vy tuš i t	PRSI
vy tvar ova t	PRSI
vy tvář e t	PRSI
vy táh nou t	PRSI
vy táč e t	PRSI
vy ték a t	PRSI
vy tír a t	PRSI
vy tíž i t	PRSI
vy týk a t	PRSI
vy těž i t	PRSI
vy třep a t	PRSI
vy třep á v a t	PRSSSI
vy třešt i t	PRSI
vy třešt ěn ý	PRSI
vy třás a t	PRSI
vy třás t	PRI
vy tříb i t	PRSI
vy tříd i t	PRSI
vy třísk a t	PRSI
vy tř í t	PRSI
vy um ě l k ova t	PRSSSSI
vy uč i t	PRSI
vy uč ova t	PRSI
vy uč ová n í	PRSSS
vy uč uj íc í	PRSSI
vy u ží v a t	PPRSSI
vy val i t	PRSI
vy val ova t	PRSI
vy var ova t	PRSI
vy vaz ova t	PRSI
vy vař i t	PRSI
vy vař ova t	PRSI
vy ven č i t	PRSSI
vy vlast ň ova t	PRSSI
vy vléc i	PRI
vy vlík a t	PRSI
vy vol a t	PRSI
vy vol i t	PRSI
vy vol á v a t	PRSSSI
vy vrac e t	PRSI
vy vrch ol i t	PRSSI
vy vrh a t	PRSI
vy vrh e l	PRSS
vy vrh nou t	PRSI
vy vrt a t	PRSI
vy vrt nou t	PRSI
vy vrt á v a t	PRSSSI
vy vrt ě t	PRSI
vy vrz a t	PRSI
vy vrát i t	PRSI
vy vrávor a t	PRSI
vy v stá v a t	PPRSSI
vy vz tek a t	PRRSI
vy vál e t	PRSI
vy vá t	PRI
vy váz a t	PRSI
vy váz nou t	PRSI
vy váž e c í	PRSSI
vy váž en ě	PRSI
vy větr a t	PRSI
vy větr á n í	PRSSS
vy větř i t	PRSI
vy věš ova t	PRSI
vy vřísk nou t	PRSI
vy zař ova t	PRSI
vy zdvih ova t	PRSI
vy zdvih á v a t	PRSSSI
vy zd í v a t	PRSSSI
vy z koum a t	PPRSI
vy z kouš e t	PPRSI
vy z kus i t	PRRSI
vy znam en á v a t	PRSSSSI
vy zn a t	PRSI
vy znač i t	PRSI
vy znač ova t	PRSI
vy zn á v a t	PRSSSI
vy zn í t	PRSI
vy zn í v a t	PRSSSI
vy zob a t	PRSI
vy zou t	PRI
vy zou v a t	PRSSI
vy z po víd a t	PPPRSI
vy z pyt ova t	PPRSI
vy z pě v ova t	PPRRSI
vy z rad i t	PPRSI
vy z raz ova t	PPRSI
vy zrá t	PRI
vy zrá v a t	PRSSI
vy z tuž i t	PPRSI
vy z tuž ova t	PPRSI
vy zuř i t	PRSI
vy z ved nu t í	PPRSSI
vy z ved á v a c í	PPRSSSSI
vy zván ě t	PRSI
vy z víd a t	PPRSI
vy z věd a č	PPRSS
vy z věd a č stv í	PPRSSSS
vy z věd ě t	PPRSI
vy zář i t	PRSI
vy získ a t	PRSI
vy zýv a t	PRSI
vy čar ova t	PRSI
vy čas ova t	PRSI
vy čenich a t	PRSI
vy čep ova t	PRSI
vy čerp a n ý	PRSSI
vy čerp a t	PRSI
vy čerp á v aj íc í	PRSSSSI
vy čerp á v a t	PRSSSI
vy čes a t	PRSI
vy čes á v a t	PRSSSI
vy čich a t	PRSI
vy čich nou t	PRSI
vy čin i t	PRSI
vy čist i t	PRSI
vy čišť ova t	PRSI
vy čk a t	PRSI
vy čk á v a t	PRSSSI
vy člen i t	PRSI
vy čleň ova t	PRSI
vy čmuch a t	PRSI
vy čp ě t	PRSI
vy čuch a t	PRSI
vy čur a t	PRSI
vy čár k ova t	PRSSI
vy číh a t	PRSI
vy číh nou t	PRSI
vy čísl i t	PRSI
vy čísl ova t	PRSI
vy řad i t	PRSI
vy řaz ova t	PRSI
vy řez a t	PRSI
vy řez á v a t	PRSSSI
vy řeš en í	PRSI
vy řiz ova t	PRSI
vy řiz ová n í	PRSSS
vy řád i t	PRSI
vy říd i t	PRSI
vy říz nou t	PRSI
vy říz nu teln ý	PRSSI
vy šach ová v á n í	PRSSSSS
vy šetř ova c í	PRSSI
vy šetř ova t	PRSI
vy šetř ova tel	PRSS
vy škleb ova t	PRSI
vy škobrt a t	PRSI
vy škol en í	PRSI
vy škol i t	PRSI
vy škrt a t	PRSI
vy škrt nou t	PRSI
vy škrt á v a t	PRSSSI
vy škub a t	PRSI
vy škub nou t	PRSI
vy škvař i t	PRSI
vy šlap a t	PRSI
vy šlap ova t	PRSI
vy šleh a t	PRSI
vy šleh nou t	PRSI
vy šláp nou t	PRSI
vy šoup nou t	PRSI
vy šplh a t	PRSI
vy šplích a t	PRSI
vy šplích nou t	PRSI
vy šroub ova t	PRSI
vy šroub ová v a t	PRSSSI
vy štv a t	PRSI
vy štíp a t	PRSI
vy štíp nou t	PRSI
vy štěbet a t	PRSI
vy štěk nou t	PRSI
vy švih nou t	PRSI
vy ší t	PRI
vy ší v a t	PRSSI
vy šťour a t	PRSI
vy ťuk a t	PRSI
vy ťuk á v a t	PRSSSI
vy žad on i t	PRSSI
vy žal ova t	PRSI
vy žehl i t	PRSI
vy žeh nou t	PRSI
vy žen i t	PRSI
vy žmol i t	PRSI
vy žvan i t	PRSI
vy žád a t	PRSI
vy žád á n í	PRSSS
vy žíh a t	PRSI
vy žín a t	PRSI
vy žír a t	PRSI
v zad u	PRI
vz bouz e t	PRSI
vz bouř i t	PRSI
vz dech nou t	PRSI
vz dou t	PRI
vz dych a t	PRSI
vz dych nou t	PRSI
vz děl a n ý	PRSSI
vz děl a t	PRSI
vz děl a v a tel sk ý	PRSSSSSI
vz děl a v a tel ův	PRSSSSI
vz děl á v a t	PRSSSI
vz děl á v á n í	PRSSSSS
vze jí t	PRI
vze př í t	PRSI
vz kaz	PR
vz kaz ova t	PRSI
vz klíč i t	PRSI
vz kvét a t	PRSI
vz kyp ě t	PRSI
vz káz a t	PRSI
vz let ě t	PRSI
vz lín a t	PRSI
vz moc i	PRI
vz muž i t	PRSI
vz nés t	PRI
v zor	PR
vz pamat ova t	PRSI
vz paž i t	PRSI
vz po mín k a	RSRSI
vz pruž i t	PRSI
vz pruž ova t	PRSI
vz pír a t	PRSI
vz přim ova t	PRSI
vz přím i t	PRSI
vz příč i t	PRSI
vz ruš i t	PRSI
vz ruš ova t	PRSI
vz růst a t	PRSI
vz tek	PR
vz tek a t	RRSI
vz tek l e	PRSI
vz tek nou t	RRSI
vz tyč i t	PRSI
vz tyč ova t	PRSI
v zýv a t	PRSI
váb i t	RSI
váb n ý	RSI
válč i t	RSI
vápen at ě t	RSSI
vápn i t	RSI
vápn o	RI
vá t	RI
váz a n k a	RSSSI
váz a t	RSI
váz nou t	RSI
véz t	RI
víd a t	RSI
víd á v a t	RSSSI
vín o	RI
vír a	RI
ví t	RI
vít a t	RSI
vítr	R
vítěz i t	RSI
vítěz n ě	RSI
víč k ova t	RSSI
víř i t	RSI
v úst i t	PRSI
vý kon	PR
vý kup n í	PRSI
vý let	PR
vý mluv n ost	PRSS
vý měn a	PRI
vý pot ek	PRI
vý po věď	RSR
vý raz n ý	PRSI
vý raz n ě	PRSI
vý rob a	PRI
vý rob c e	PRSI
vý rob ek	PRI
vý rob n í	PRSI
výsk a t	RSI
výsk nou t	RSI
vý sled ek	PRI
vý stup n í	PRSI
vý tah	PR
vý těž ek	PRI
výš e	RI
výš k a	RSI
v čas	PR
včel a	RI
včel ař i t	RSSI
v člen i t	PRSI
v čleň ova t	PRSI
věd a	RI
věd ec	RI
věd ec k ý	RSSI
věd ě n í	RSSI
věd ě t	RSI
věk	R
věr n ost	RSS
větr á n í	RSSS
větv i t	RSI
větř i t	RSI
věz e n í	RSSS
věz e t	RSI
věz n i t	RSSI
věč n ost	RSS
věč n ě	RSI
věř en í	RSI
věř i t	RSI
věř i tel	RSS
věř íc í	RSS
věš e t	RSI
věšt i t	RSI
věž	R
v řad i t	PRSI
v řaz ova t	PRSI
v řaď ova t	PRSI
v řez a t	PRSI
v řez á v a t	PRSSSI
vřísk a t	RSI
vřísk nou t	RSI
vř í t	RSI
v řít i t	PRSI
v říz nou t	PRSI
v šept nou t	PRSI
v štěp ova t	PRSI
vším a t	RSI
v ší v a t	PRSSI
vůl	R
vůl e	RI
vůz	R
za baf a t	PRSI
za baf nou t	PRSI
za bahn i t	PRSI
za bahň ova t	PRSI
za bal ený	PRS
za bal i t	PRSI
za bal ova t	PRSI
za bav i t	PRSI
za bav ova t	PRSI
za bedn i t	PRSI
za bedn ěn ec	PRSI
za bedň ova t	PRSI
za beton ova t	PRSI
za blik a t	PRSI
za blýsk a t	PRSI
za blýsk nou t	PRSI
za bod a t	PRSI
za bod nou t	PRSI
za bod á v a t	PRSSSI
za bol e t	PRSI
za bouch nou t	PRSI
za bouch á v a t	PRSSSI
za bouř i t	PRSI
za boč ova t	PRSI
za boř i t	PRSI
za brn ě t	PRSI
za brouk a t	PRSI
za brous i t	PRSI
za bruč e t	PRSI
za bruš ova t	PRSI
za brán i t	PRSI
za bubn ova t	PRSI
za bud ova t	PRSI
za buš i t	PRSI
za bydl e t	PRSI
za bíl i t	PRSI
za bý v a t	PRSSI
za běh a t	PRSI
za běh á v a t	PRSSSI
za běl a t	PRSI
za cement ova t	PRSI
za chlad i t	PRSI
za chlaz ova t	PRSI
za chov a t	PRSI
za chov á n í	PRSSS
za chov á v a t	PRSSSI
za chraň ova t	PRSI
za chrchl a t	PRSI
za chrán i t	PRSI
za cht í t	PRSI
za chut n a t	PRSSI
za chví v a t	PRSSI
za chvě t	PRI
za chyc ova t	PRSI
za chyt i t	PRSI
za chyt nou t	PRSI
za cink a t	PRSI
za cink nou t	PRSI
za clon i t	PRSI
za cloň ova t	PRSI
za couv a t	PRSI
za cp á v a t	PRSSSI
za cuk a t	PRSI
za cvak a t	PRSI
za cvak nou t	PRSI
za cvič i t	PRSI
za cvič ova t	PRSI
za cvál a t	PRSI
za cák a t	PRSI
za cíl i t	PRSI
zad ek	RS
zad eček	RS
za dlab á v a t	PRSSSI
za dluž i t	PRSI
za dluž ova t	PRSI
za dou t	PRI
za drh nou t	PRSI
za drh ova t	PRSI
za drž ova t	PRSI
za dum a t	PRSI
za dup a t	PRSI
za dup nou t	PRSI
za dup á v a t	PRSSSI
za dus i t	PRSI
za duš ova t	PRSI
za dáv i t	PRSI
za dír a t	PRSI
za dív a t	PRSI
za dých á v a t	PRSSSI
za dým a t	PRSI
za děl a t	PRSI
za děl á v a t	PRSSSI
za dř í t	PRSI
za fix ova t	PRSI
za flák a t	PRSI
za fouk nou t	PRSI
za frk a t	PRSI
za haj ova t	PRSI
za hal i t	PRSI
za hal ova t	PRSI
za han b en ě	PRSSI
za han b i t	PRSSI
za haz ova t	PRSI
za haš en í	PRSI
za hlad i t	PRSI
za hlaz ova t	PRSI
za hled ě t	PRSI
za hloub a t	PRSI
za hn a t	PRSI
za hní t	PRI
za hní v a t	PRSSI
za hnízď ova t	PRSI
za hod i t	PRSI
za hoj i t	PRSI
za hospod ař i t	PRSSI
za houk nou t	PRSI
za houp a t	PRSI
za hrab a t	PRSI
za hrab ova t	PRSI
za hrad i t	PRSI
za hran ič n í	PRSSI
za hran ič í	PRSI
za hraz ova t	PRSI
za hrk a t	PRSI
za hr nou t	PRSI
za hrom ova t	PRSI
za hrot i t	PRSI
za hroz i t	PRSI
za hryz nou t	PRSI
za hráb nou t	PRSI
za hrá t	PRI
za hrá v a t	PRSSI
za hub i t	PRSI
za hulák a t	PRSI
za hušť ova t	PRSI
za hvízd a t	PRSI
za hvízd nou t	PRSI
za háj i t	PRSI
za hák ova t	PRSI
za ház e t	PRSI
za háč k ova t	PRSSI
za hýb a t	PRSI
za hřm í t	PRSI
za hřm ě t	PRSI
za hřá t	PRI
za hřím a t	PRSI
za j at ec	PRSI
za je t	PRI
za jezd i t	PRSI
za ječ e t	PRSI
za jiskř i t	PRSI
za jist é	PRI
za jizv i t	PRSI
za jizv ova t	PRSI
za jišt ěn í	PRSI
za jišť ova t	PRSI
za jás a t	PRSI
za jíd a t	PRSI
za jím a v ý	PRSSI
za jí t	PRI
za jížd ě n í	PRSSI
za kal i t	PRSI
za kal ova t	PRSI
za kap a t	PRSI
za kap á v a t	PRSSSI
za kaz ova t	PRSI
za kec a t	PRSI
za klap nou t	PRSI
za klep a t	PRSI
za klep nou t	PRSI
za kles nou t	PRSI
za kles nu t í	PRSSI
za kles nut ý	PRRI
za kle t í	PRSI
za klop i t	PRSI
za klopýt nou t	PRSI
za kloň ova t	PRSI
za kláp ě t	PRSI
za klí n a t	PRSSI
za klín ova t	PRSI
za klí t	PRI
za klíž i t	PRSI
za kmit a t	PRSI
za kokt a t	PRSI
za koléb a t	PRSI
za kolís a t	PRSI
za konč i t	PRSI
za konč ova t	PRSI
za kop a t	PRSI
za kop nou t	PRSI
za kop á v a t	PRSSSI
za kotv en í	PRSI
za kotv i t	PRSI
za kotv ova t	PRSI
za kouk a t	PRSI
za koul e t	PRSI
za koup i t	PRSI
za kous nou t	PRSI
za kous á v a t	PRSSSI
za kouř i t	PRSI
za kořen i t	PRSI
za kořeň ova t	PRSI
za kroj i t	PRSI
za krout i t	PRSI
za krouž i t	PRSI
za kruc ova t	PRSI
za krv av ě t	PRSSI
za krv ác e t	PRSSI
za krám ova t	PRSI
za krý t	PRI
za krý v a t	PRSSI
za kuk a t	PRSI
za kul ac ova t	PRSSI
za kul at i t	PRSSI
za kup ova t	PRSI
za kut a t	PRSI
za kutál e t	PRSI
za kuř ova t	PRSI
za kvas i t	PRSI
za kvaš ova t	PRSI
za kyd a n ý	PRSSI
za kys a t	PRSI
za kys e l ová n í	PRSSSSS
za kys nou t	PRSI
za kys á v a t	PRSSSI
za káp nou t	PRSI
za káz a t	PRSI
za kód ova t	PRSI
za křik nou t	PRSI
za křik ova t	PRSI
za křiv i t	PRSI
za křiv ova t	PRSI
za křič e t	PRSI
za lahod i t	PRSI
za lak ova t	PRSI
za lap a t	PRSI
za lecht a t	PRSI
za lek nou t	PRSI
za lem ova t	PRSI
za lesk nou t	PRSI
za les n i t	PRSSI
za les ň ova t	PRSSI
za let ova t	PRSI
za let ě t	PRSI
za lh a t	PRSI
za lh á v a t	PRSSSI
za lichot i t	PRSI
za list ova t	PRSI
za lit ova t	PRSI
za lom i t	PRSI
za lov i t	PRSI
za lož en í	PRSI
za lož en ý	PRSI
za lož i t	PRSI
za lát a t	PRSI
za lét a t	PRSI
za lét nou t	PRSI
za lé v a t	PRSSI
za léz a t	PRSI
za léz t	PRI
za líc ova t	PRSI
za lí t	PRI
za lít a t	PRSI
za lít á v a t	PRSSSI
za líz a t	PRSI
za manévr ova t	PRSI
za mask ova t	PRSI
za mast i t	PRSI
za maz a t	PRSI
za maz áv ač	PRSS
za mačk a t	PRSI
za mačk á v a t	PRSSSI
z amerik an iz ova t	PRSSSI
za met a t	PRSI
za meč e t	PRSI
za mešk a t	PRSI
za mešk á v a t	PRSSSI
za mhouř i t	PRSI
za mhuř ova t	PRSI
za mil ova n ý	PRSSI
za mil ova n ě	PRSSI
za mil ova t	PRSI
za mil ová v a t	PRSSSI
za mk nou t	PRSI
za mlouv a t	PRSI
za mluv i t	PRSI
za mlč ova t	PRSI
za mlž i t	PRSI
za mlž ova t	PRSI
za mont ova t	PRSI
za mot a t	PRSI
za mot á v a t	PRSSSI
za moř en ý	PRSI
za mraz i t	PRSI
za mrač en ost	PRSS
za mrač i t	PRSI
za mrk a t	PRSI
za mrsk a t	PRSI
za mrz e t	PRSI
za myk a t	PRSI
za mysl e t	PRSI
za myšl e n ý	PRSSI
za myšl e n ě	PRSSI
za máv a t	PRSI
za máv nou t	PRSI
za máč e t	PRSI
za mích a t	PRSI
za mít a t	PRSI
za mít nou t	PRSI
za míř i t	PRSI
za mýšl e t	PRSI
za měň ova t	PRSI
za měř ova t	PRSI
za mř í t	PRSI
za mříž ova t	PRSI
za na řík a t	PPRSI
za nech a t	PRSI
za nech á v a t	PRSSSI
za not ova t	PRSI
za nož i t	PRSI
za nož ova t	PRSI
za náš e t	PRSI
za nés t	PRI
za nýt ova t	PRSI
za o bal i t	PPRSI
za o bal ova t	PPRSI
za o krouh l i t	PPRSSI
za o krouh l ova t	PPRSSI
za olej ova t	PRSI
za o patř i t	PPRSI
za o patř ova t	PPRSI
za ostř ova t	PRSI
za pad aj íc í	PRSSI
za pad a t	PRSI
za pad nou t	PRSI
za pad á v a t	PRSSSI
za pal ova t	PRSI
za pamat ova t	PRSI
za pamat ová n í	PRSSS
za park ova t	PRSI
za pař i t	PRSI
za pař ova t	PRSI
za paž i t	PRSI
za pečet i t	PRSI
za pich ova t	PRSI
za pil ova t	PRSI
za pis ova t	PRSI
za pis ova tel ův	PRSSI
za plak a t	PRSI
za pla nou t	PRSI
za plat i t	PRSI
za plav a t	PRSI
za plav i t	PRSI
za plav ova t	PRSI
za plaš i t	PRSI
za plaš ova t	PRSI
za plesk a t	PRSI
za plev el i t	PRRSI
za pliv a t	PRSI
za pln i t	PRSI
za pln ěn ý	PRSI
za plomb ova t	PRSI
za plác a t	PRSI
za plét a t	PRSI
za plét á v a t	PRSSSI
za po chyb ova t	PPRSI
za pot i t	PRSI
za poušt ě t	PRSI
za po víd a t	PPRSI
za po věd ě t	PPRSI
za po věz e n ý	PPRSSI
za po ší t	PPRI
za po ší v a t	PPRSSI
za prac ova t	PRSI
za prask a t	PRSI
za prask nou t	PRSI
za pr a t	PRSI
za prav i t	PRSI
za prav ova t	PRSI
za praž i t	PRSI
za pros i t	PRSI
za prsk nou t	PRSI
za prásk a t	PRSI
za prásk nou t	PRSI
za práš en ý	PRSI
za práš i t	PRSI
za prš e t	PRSI
za ps a t	PRSI
za pud i t	PRSI
za pudr ova t	PRSI
za pust i t	PRSI
za puz ova t	PRSI
za pytl ač i t	PRSSI
za páj e t	PRSI
za pál i t	PRSI
za pátr a t	PRSI
za péc i	PRI
za pék a t	PRSI
za pích a t	PRSI
za pích nou t	PRSI
za pík a t	PRSI
za pín a t	PRSI
za píp nou t	PRSI
za pěn i t	PRSI
za pě t	PRI
za při sáh nou t	PPRSI
za pří sah a t	PPRSI
za půjč i t	PRSI
za půjč ova t	PRSI
za rad ova t	PRSI
z aranž ova t	PRSI
za raz i t	PRSI
za raž en ě	PRSI
za rd í v a t	PRSSSI
za re ag ova t	PPRSI
za re cit ova t	PPRSI
za registr ova t	PRSI
za rez av ě t	PRSSI
za rmout i t	PRSI
za rmuc ova t	PRSI
za roj i t	PRSI
za rol ova t	PRSI
za ros i t	PRSI
za ruč i t	PRSI
za ruč ova t	PRSI
za ryb n i t	PRSSI
za rám ova t	PRSI
za ráž e t	PRSI
za rýp a t	PRSI
za rýp nou t	PRSI
za rý t	PRI
za rý v a t	PRSSI
za růst a t	PRSI
za růž ov ě t	PRSSI
za sch nou t	PRSI
za sek a t	PRSI
za sek á v a t	PRSSSI
za skl í v a t	PRSSSI
za skoč i t	PRSI
za skříp a t	PRSI
za skříp nou t	PRSI
za slouž i t	PRSI
za sluh ova t	PRSI
za slz e t	PRSI
za smaž ova t	PRSI
za smol i t	PRSI
za snoub i t	PRSI
za snub ova t	PRSI
za sn í t	PRSI
za sn í v a t	PRSSSI
za sněž i t	PRSI
za sol ova t	PRSI
za sp a t	PRSI
za sp á v a t	PRSSSI
za star a t	PRSI
za sta t	PRI
za stih nou t	PRSI
za stiň ova t	PRSI
za ston a t	PRSI
za stoup en í	PRSI
za stoup i t	RRSI
za straš i t	PRSI
za straš ova t	PRSI
za strk a t	PRSI
za strk ova t	PRSI
za strk á v a t	PRSSSI
za strč i t	PRSI
za stá n í	PRSS
za stá v a t	PRSSI
za stín i t	PRSI
za stír a t	RRSI
za stýsk a t	PRSI
za střel i t	PRSI
za střel ova t	PRSI
za střeš i t	PRSI
za střeš ova t	PRSI
za střík a t	PRSI
za stříl e t	PRSI
za stř í t	PRSI
za svin i t	PRSI
za svít i t	PRSI
za svěc ova t	PRSI
za svět i t	PRSI
za syc ova t	PRSI
za syk nou t	PRSI
za syp á v a t	PRSSSI
za syt i t	PRSI
za syč e t	PRSI
za tah a t	PRSI
za taj i t	PRSI
za tanc ova t	PRSI
za tanč i t	PRSI
za tav i t	PRSI
za tem n i t	PRSSI
za tem n ě t	PRSSI
za tem ň ova t	PRSSI
za tesk n i t	PRSSI
za tik a t	PRSI
za tlač i t	PRSI
za tlač ova t	PRSI
za tlesk a t	PRSI
za tlouk a t	PRSI
za t nou t	PPPI
za toul a t	PRSI
za touž i t	PRSI
za toč i t	PRSI
za trac ova t	PRSI
za trat i t	PRSI
za trh a t	PRSI
za trh nou t	PRSI
za trh ova t	PRSI
za trh á v a t	PRSSSI
za troub i t	PRSI
za tráp en ý	PRSI
za tráv n i t	PRSSI
za trén ova t	PRSI
za tuch nou t	PRSI
za tvrd i t	PRSI
za tvrd nou t	PRSI
za táč e t	PRSI
za táč k a	PRSI
za ték a t	PRSI
za tír a t	PRSI
za tíž en í	PRSI
za tíž en ý	PRSI
za tíž i t	PRSI
za týk a t	PRSI
za těž k a t	PRSSI
za těž ova t	PRSI
za třep a t	PRSI
za třás t	PRI
za tř í t	PRSI
za u j a t ý	PPRSSI
za u j e t í	PPRSSS
z auto mat iz ova t	PRRSSI
za uč ova t	PRSI
za vad i t	PRSI
za val ova t	PRSI
za vaz ova t	PRSI
za vaz uj íc í	PRSSI
za vel e t	PRSI
za vesl ova t	PRSI
za vin i t	PRSI
za viň ova t	PRSI
za vlaž i t	PRSI
za vlaž ova t	PRSI
za vlád nou t	PRSI
za vlá t	PRI
za vléc i	PRI
za vlék a t	PRSI
za vlík a t	PRSI
za vod n i t	PRSSI
za vol a t	PRSI
za von ě t	PRSI
za vrt a t	PRSI
za vrt á v a t	PRSSSI
za vrt ě t	PRSI
za vrz a t	PRSI
za vrz nou t	PRSI
za vrávor a t	PRSI
za vrč e n í	PRSSI
za vrč e t	PRSI
za vtip k ova t	PRSSI
za vz dych a t	PPRSI
za vz dych nou t	PPRSI
za vál e t	PRSI
za váz a n ý	PRSSI
za váz e t	PRSI
za víj e t	PRSI
za vír a t	PRSI
za ví t	PRI
za vít a t	PRSI
za víč k ova t	PRSSI
za víř i t	PRSI
za výsk nou t	PRSI
za věs i t	PRSI
za věš ova t	PRSI
za vř e n ý	PRSSI
za vřísk a t	PRSI
za vřísk nou t	PRSI
za vř í t	PRSI
za vš iv i t	PRSSI
za zd í v a t	PRSSSI
za zelen a t	PRSI
za zim ova t	PRSI
za znam en a t	PRSSI
za znam en á v a t	PRSSSSI
za zn í t	PRSI
za zub i t	PRSI
za zvon i t	PRSI
za zvuč e t	PRSI
za čad i t	PRSI
za čaz ova t	PRSI
za čep ova t	PRSI
za čepýř i t	PRSI
za čern a t	PRSI
za čern i t	PRSI
za červen a t	PRSI
za čes a t	PRSI
za čist i t	PRSI
za čisť ova t	PRSI
za čišť ova t	PRSI
za člen i t	PRSI
za čleň ova t	PRSI
za čmár a t	PRSI
za čoud i t	PRSI
za čuz ova t	PRSI
za řad i t	PRSI
za řad i teln ý	PRSSI
za řaz en í	PRSI
za řaz en ý	PRSI
za řaz ova t	PRSI
za řek nou t	PRSI
za řez á v a t	PRSSSI
za řiz ova t	PRSI
za řiz ova tel	PRSS
za řv a t	PRSI
za řád i t	PRSI
za říc i	PRI
za říd i t	PRSI
za řík a t	PRSI
za říz en í	PRSI
za říz nou t	PRSI
za šept a t	PRSI
za šept nou t	PRSI
za šetř i t	PRSI
za šifr ova t	PRSI
za šilh a t	PRSI
za škobrt a t	PRSI
za škobrt nou t	PRSI
za škobrt á v a t	PRSSSI
za škol en í	PRSI
za škol i t	PRSI
za škrt a t	PRSI
za škrt i t	PRSI
za škrt nou t	PRSI
za škrt á v a t	PRSSSI
za škub a t	PRSI
za šlap a t	PRSI
za šleh a t	PRSI
za šláp nou t	PRSI
za šmel i t	PRSI
za šmodrch a t	PRSI
za šmodrch á v a t	PRSSSI
za šmudl a t	PRSI
za šněr ova t	PRSI
za šoup nou t	PRSI
za špendl i t	PRSI
za špin i t	PRSI
za špič at i t	PRSSI
za šplouch a t	PRSI
za šplouch nou t	PRSI
za šroub ova t	PRSI
za šroub ová v a t	PRSSSI
za štip ova t	PRSI
za štíp nou t	PRSI
za štěk nou t	PRSI
za šum ě t	PRSI
za šust i t	PRSI
za švih a t	PRSI
za švih nou t	PRSI
za švindl ova t	PRSI
za ší t	PRI
za ší v a t	PRSSI
za ťap a t	PRSI
za ťuk a t	PRSI
za žehn a t	PRSI
za žehn á v a t	PRSSSI
za žeh ova t	PRSI
za žh nou t	PRSI
za ži t í	PRSI
za ži t ý	PRSI
za žíh a t	PRSI
za ží t	PRI
z babr a t	PRSI
z barv i t	PRSI
z barv ova t	PRSI
z bav i t	PRSI
z bav ova t	PRSI
z bloud i t	PRSI
z blázn i t	PRSI
z bod a t	PRSI
z boh at nou t	PRSSI
z bour a t	PRSI
z boř i t	PRSI
z braň ova t	PRSI
z brous i t	PRSI
z bruš ova t	PRSI
z brázd i t	PRSI
z bubn ova t	PRSI
z bud ova t	PRSI
z buj e t	PRSI
z bád a t	PRSI
z básn i t	PRSI
z básň ova t	PRSI
z bíd ač i t	PRSSI
z bý v aj íc í	PRSSSI
z běh a t	PRSI
z běl a t	PRSI
z běl i t	PRSI
z centr al iz ova t	PRSSSI
z cenzur ova n ý	PRSSI
z chlad i t	PRSI
z chlad nou t	PRSI
z chlaz ova t	PRSI
z chod i t	PPPI
z chrup nou t	PRSI
z civil iz ova t	PRSSI
z ciz ova t	PRSI
z cuch a t	PRSI
z cuker n at ě t	PRSSSI
z dan i t	PRSI
z dar	PR
z daň ova c í	PRSSI
z daň ova t	PRSI
z dař i t	PRSI
z de form ova t	PPRSI
z de gener ova t	PPRSI
z div oč e t	PRSSI
z dluž ova t	PRSI
z do kon a l i t	PPRSSSI
z do kon a l i teln ý	PPRSSSSI
z do kon a l ova t	PPRSSSI
z dou t	PRI
z dou v a t	PRSSI
zdrav i t	RSI
zdrav ot nic tv í	RSSSS
zdrav ot n í	RSSI
zdrav ý	RI
zdrav ě	RI
z draž i t	PRSI
z draž ova t	PRSI
z drb a t	PRSI
z drb nou t	PRSI
z drc en ě	PRSI
z drt i t	PRSI
z dráp a t	PRSI
z drás a t	PRSI
z drž e nliv ost	PRSSS
z drž e t	PRSI
z dus a t	PRSI
zdvih a t	RSI
zdvih nou t	RSI
z dvoř i l e	PRSSI
z dvoř i l ost	PRSSS
z dvoř i l ý	PRSSI
zd í t	RSI
z děd i t	PRSI
z děs i t	PRSI
z dět in št ě t	PRSSSI
z dřím nou t	PRSI
zed nič i t	RSSI
zed ník	RS
ze dř í t	PRSI
z elektr iz ova t	PRSSI
zelen a t	RSI
zelen in a	RSI
zelen ý	RI
zelen ě	RI
zeleň	R
ze mdl é v a t	PRSSSI
ze mdl í t	PRSI
ze mdl í v a t	PRSSSI
zem sk ý	RSI
zem ák	RS
ze ps ou t	PRSI
ze pt a t	PRSI
ze sil ova t	PRSI
ze sin a t	PRSI
ze slab i t	PRSI
ze slab ova t	PRSI
ze sláb nou t	PRSI
ze smut ň ova t	PRSSI
ze star a t	PRSI
ze styl iz ova t	PRSSI
ze stát n i t	PRSSI
ze stát ň ova t	PRSSI
ze svět l ová n í	PRSSSS
ze síl i t	PRSI
ze síť ova t	PRSI
ze zelen a t	PRSI
zeď	R
ze šed iv ě t	PRSSI
ze špič at ě t	PRSSI
ze šíř i t	PRSI
ze žlout nou t	PRSI
z falš ova t	PRSI
z faš iz ova t	PRSSI
z feder al iz ova t	PRSSSI
z filtr ova t	PRSI
z fix ova t	PRSI
z form ova t	PRSI
z harmon iz ova t	PRSSI
z has i t	PRSI
z has nou t	PRSI
z has í n a t	PRSSSI
z hloup nou t	PRSI
z hlt nou t	PRSI
z hnus i t	PRSI
z hněd nou t	PRSI
z hoj i t	PRSI
z host i t	PRSI
z hotov en í	PRSI
z hotov i t	PRSI
z hotov ova t	PRSI
z houb n ý	PRSI
z houst nou t	PRSI
z hroz i t	PRSI
z hrub nou t	PRSI
z hub en ě t	PRSSI
z hub nou t	PRSI
z hust i t	PRSI
z hušť ova t	PRSI
z ideal iz ova t	PRSSI
zim a	RI
zim n í	RSI
zim n ík	RSS
zim ova t	RSI
z instrument ova t	PRSI
zisk	R
z jan č i t	PRSSI
z jas n ě t	PRSSI
z je t	PRI
z jev i t	PRSI
z jež i t	PRSI
z jizv i t	PRSI
z jišť ova t	PRSI
z kadeř i t	PRSI
z kal i t	PRSI
z kamen ěl ý	PRSI
z kamen ě t	PRSI
z kap al n i t	PRSSSI
z kap al n ě t	PRSSSI
z kap al ň ova t	PRSSSI
z kapital iz ova t	PRSSI
z kaz i t	PRSI
z klam a n ě	PRSSI
z klam a t	PRSI
z klam á n í	PRSSS
z klid n ě t	PRSSI
z koléb a t	PRSI
z kombin ova t	PRSI
z kom pon ova t	PRRSI
z kompost ova t	PRSI
z konejš i t	PRSI
z kon stru ova t	PRRSI
z kontrol ova t	PRSI
z ko ordin ova t	PPRSI
z kop a t	PRSI
z ko rmout i t	PPRSI
z kor n at ě t	PRSSSI
z kos i t	PRSI
z kost n at ě t	PRSSSI
z koum a t	PRSI
z koup a t	PRSI
z kouš k a	PRSI
z krac ova t	PRSI
z krm i t	PRSI
z krm ova t	PRSI
z krop i t	PRSI
z krot i t	PRSI
z krot nou t	PRSI
z krout i t	PRSI
z krv av ě t	PRSSI
z krv ác e t	PRSSI
z krystal iz ova t	PRSSI
z kráp ě t	PRSI
z krás n ě t	PRSSI
z krát i t	PRSI
z krát k a	PRSS
z kráš l i t	PRSSI
z kráš l ova t	PRSSI
z kul at i t	PRSSI
z kul at ě t	PRSSI
z kus i t	RRSI
z kuš en ost	PRSS
z kuš en ý	PRSI
z kvas i t	PRSI
z kvét a t	PRSI
z kys a t	PRSI
z kys nou t	PRSI
z káp nou t	PRSI
z křeh nou t	PRSI
z křiv i t	PRSI
z křís nou t	PRSI
z kříž i t	PRSI
zlat i t	RSI
zlat o	RI
zlat ý	RI
zl e	RI
z lecht a t	PRSI
z lek a t	PRSI
z lek nou t	PRSI
z len iv ě t	PRSSI
z len oš i t	PRSSI
z lev n i t	PRSSI
z lid ov ě t	PRSSI
z lid št i t	PRSSI
z likvid ova t	PRSI
z lis ova t	PRSI
zl o	RI
zl ob i t	RSSI
z lom en in a	PRSSI
z lom i t	PRSI
z lák a t	PRSI
z lám a t	PRSI
z léz a t	PRSI
z léz t	PRI
z lít a t	PRSI
zl ý	RI
z magnet iz ova t	PRSSI
z magnet ova t	PRSI
z mal ova t	PRSI
z map ova t	PRSI
z mar n i t	PRSSI
z mat ek	PRI
z mat en ý	PRSI
z maz a t	PRSI
z mačk a t	PRSI
z mař i t	PRSI
z mešk a t	PRSI
z miz e t	PRSI
z mlaz ova t	PRSI
z mlk a t	PRSI
z mlk nou t	PRSI
z mlád nou t	PRSI
z mlát i t	PRSI
z množ i t	PRSI
z moc i	PRI
z mont ova t	PRSI
z moral iz ová n í	PRSSSS
z mord ova t	PRSI
z mot a t	PRSI
z moudř e t	PRSI
z mraz i t	PRSI
z mrsk a t	PRSI
z mrz ač i t	PRSSI
z mrz e t	PRSI
z mrz nou t	PRSI
z muchl a t	PRSI
z muč i t	PRSI
z muž n ě t	PRSSI
z mách a t	PRSI
z máh a t	PRSI
z más t	PRI
z máč e t	PRSI
z máčk nou t	PRSI
z mín i t	PRSI
z mír a t	PRSI
z mít a t	PRSI
z mít á n í	PRSSS
z mýl i t	PRSI
z měk nou t	PRSI
z měk č ova t	PRSSI
zn a l ec	RSSI
zn a l ost	RSSS
znam en a t	RSSI
znač i t	RSI
znač k a	RSI
znač n ý	RSI
znač n ě	RSI
z ne svět i t	PIRSI
z ne tvoř i t	PIRSI
z ne u ct í t	PIPRSI
z ne u zn á v a t	PIPRSSSI
z ne u ží v a t	PIPRSSI
z ne čist i t	PIRSI
z ne čisť ova t	PIRSI
z ne čišť ova t	PIRSI
z nič en ý	PRSI
z nič en ě	PRSI
z nič i t	PRSI
z norm al iz ova t	PRSSSI
z norm ova t	PRSI
z nud i t	PRSI
zn ám ý	RRI
z ná rod n i t	PPRSSI
z ná rod ň ova t	PPRSSI
z ná sil n i t	PPRSSI
z ná sil ň ova t	PPRSSI
z násob i t	PRSI
z násob ova n ý	PRSSI
z násob ova t	PRSI
zn á t	RSI
zn í t	RSI
zn ě n í	RSSI
zob a t	RSI
z obec n i t	PRSSI
zob nou t	RSI
z ocel i t	PRSI
z ocel ova t	PRSI
z od po víd a t	PPPRSI
z od po věd n ost	PPPRSS
z od po věd n ě	PPPRSI
z o hyzd i t	PPRSI
z o hyzď ova t	PPRSI
z o hýb a t	PPRSI
z o stouz e t	PPRSI
z ostř i t	PRSI
z ostř ova t	PRSI
z ote vír a t	PRRSI
z otroč i t	PRSI
z otroč ova t	PRSI
z ot vír a t	PRRSI
zoub k ova t	RSSI
zouf a l e	RSSI
zouf al ý	RSI
zouf a t	RSI
zou t	RI
zou v a t	RSSI
z oxid ova t	PRSI
z oč i t	PRSI
z oškliv ova t	PRSI
z oškliv ě t	PRSI
z pacht ova t	PRSI
z pan ák ova t	PRSSI
z patl a t	PRSI
z peněž i t	PRSI
z pevn i t	PRSI
z pečet i t	PRSI
z plak a t	PRSI
z plen i t	PRSI
z pleš at ě t	PRSSI
z plod i t	PRSI
z poc en ý	PRSI
z poet iz ova t	PRSSI
z po hlav k ova t	PPRSSI
z pol ar iz ova t	PRSSSI
z po lám a t	PPRSI
z popel av ě t	PRSSI
z popel n i t	PRSSI
z po ráž e t	PPRSI
z pot i t	PRSI
z po víd a t	PPRSI
z po zor ova t	PPRSI
z požď ova c í	PRSSI
z požď ova t	PRSI
z prac ova t	PRSI
z prac ová n í	PRSSS
z prac ová v a t	PRSSSI
z prav i t	PRSI
z prav ova t	PRSI
z praž i t	PRSI
z pro hýb a t	PPRSI
z pro střed k ova n ý	PPRSSSI
z pro střed k ova n ě	PPRSSSI
z pro střed k ova t	PPRSSI
z pro střed k ová n í	PPRSSSS
z pro střed k ová v a t	PPRSSSSI
z prásk a t	PRSI
z pust i t	PRSI
z pust nou t	PRSI
z pust oš i t	PRSSI
z pyt ova t	PRSI
z pyš n ě t	PRSSI
z pék a t	PRSI
z pí v aj íc í	PRSSSI
z pí v at	PRSI
z pěn i t	PRSI
z pře ház e t	PPRSI
z pře hýb a t	PPRSI
z pře lám a t	PPRSI
z přesň ova t	PRSI
z pře trh a t	PPRSI
z přím i t	PRSI
z příč i t	PRSI
z rad i t	PRSI
zra l ý	RSI
z ran i t	PRSI
z ran ěn í	PRSI
z raz ova t	PRSI
z raň ova t	PRSI
z real iz ova t	PRSSI
z redig ova t	PRSI
z reduk ova t	PRSI
z re form ova t	PPRSI
z re gener ova t	PPRSI
z regul ova t	PRSI
z re kon stru ova t	PPRRSI
z restaur ova t	PRSI
z re vid ova t	PPRSI
z rez av ě t	PRSSI
zrn í	RI
zrn íč k o	RSSI
z rob i t	PRSI
z rod i t	PRSI
z ros i t	PRSI
z roz en í	PRSI
z rud nou t	PRSI
z ruš en ý	PRSI
z ruš i t	PRSI
z ruš ova t	PRSI
z rychl i t	PRSI
z rychl ova t	PRSI
zrz av ý	RSI
zrz av ě t	RSSI
zrá n í	RSS
zrá t	RI
z rým ova t	PRSI
z rýp a t	PRSI
z rý t	PRI
z sin a t	PRSI
z tah a t	PRSI
z taj i t	PRSI
z tem n i t	PRSSI
z ten č i t	PRSSI
z ten č ova t	PRSSI
z tep a t	PRSI
z tich a	PRI
z tiš i t	PRSI
z tiš ová n í	PRSSS
z tlouc i	PRI
z tloust nou t	PRSI
z tlum i t	PRSI
z tm av nou t	PRSSI
z tm av ova t	PRSSI
z trat i t	PRSI
z trest a t	PRSI
z trh a t	PRSI
z trh ova t	PRSI
z trh á v a t	PRSSSI
z trác e t	PRSI
z trát a	PRI
z trát ov ý	PRSI
z trýzn i t	PRSI
z tuch nou t	PRSI
z tup i t	PRSI
z tup ě t	PRSI
z tuč n ě t	PRSSI
z tuž i t	PRSI
z tvrd i t	PRSI
z tvár n i t	PRSSI
z tvár ň ova t	PRSSI
z téc i	PRI
z týr a t	PRSI
z těž k nou t	PRSSI
z těž ova t	PRSI
zub	R
zub at ý	RSI
zub i t	RSI
z uhel n at ě t	PRSSSI
z u líb a t	PPRSI
z u líb á n í	PPRSSS
z u trh a t	PPRSI
zuř i t	RSI
zuř iv ě	RSI
z u šlecht i t	PPRSI
z u šlechť ova t	PPRSI
z už ova t	PRSI
z valch ova t	PRSI
z vandr ova t	PRSI
z ved nou t	PRSI
z veleb i t	PRSI
z verb ova t	PRSI
z vesel i t	PRSI
z vikl a t	PRSI
z viř ova t	PRSI
z vlaž i t	PRSI
z vlaž ova t	PRSI
z vlh č i t	PRSSI
z vlh č ova t	PRSSI
z vln i t	PRSI
z vlád nou t	PRSI
z vlád nu t í	PRSSI
z vláč n i t	PRSSI
z vlň ova t	PRSI
z vod n at ě t	PRSSSI
z vol i t	PRSI
z vol n i t	PRSSI
z vol ň ova t	PRSSI
zvon ek	RI
zvon ov ě	RSI
z vrac e t	PRSI
z vrt a t	PRSI
z vrt nou t	PRSI
z vrt á v a t	PRSSSI
z vrz a t	PRSI
z vrz nou t	PRSI
zvuk	R
zvuč e t	RSI
zvuč i t	RSI
z vyš ová n í	PRSSS
z váb i t	PRSI
z vál e t	PRSI
zv á t	RSI
z víd a t	PRSI
z vítěz i t	PRSI
z víř i t	PRSI
z výš en í	PRSI
z výš i t	PRSI
z věd a v ost	PRSSS
z věd a v ý	PRSSI
z věd ě t	PRSI
z větr a t	PRSI
z větr á v a t	PRSSSI
z věč n i t	PRSSI
z věč ň ova t	PRSSI
zá bav a	PRI
zá had n ý	PRSI
zá hlav í	PRS
zá jem	PR
zá kon	PR
zá kon it ý	PRSI
zá kon n ý	PRSI
zá loh ova t	PRSI
zá mek	PR
zá moř í	PRS
zá paš ek	PRI
zá sob a	RRI
zá sob i t	RRSI
zá sob ník	PRS
zá sob ova t	RRSI
zá stup	PR
zá stěr a	RRI
zá stěr k a	RRSI
zá vis l ý	PRSI
zá věr	PR
zá znam	PR
zář en í	RSI
zář íc í	RSI
získ a t	RSI
získ á n í	RSSS
získ á v a t	RSSSI
získ á v á n í	RSSSSS
zív a t	RSI
zív nou t	RSI
z úkol ova t	PRSI
z ú čast n i t	PPRSSI
z úž i t	PRSI
z čechr a t	PRSI
z čern a t	PRSI
z čern á v a t	PRSSSI
z červen a t	PRSI
z červ iv ě t	PRSSI
z čeř i t	PRSI
z češť ova t	PRSI
z řed i t	PRSI
z řeď ova t	PRSI
z říc i	PRI
z řík a t	PRSI
z řít i t	PRSI
z ů sta t	PPRI
z ů sta v i t	PPRSSI
z ů stá v a t	PPRSSI
z žen št i t	PRSSI
ú ct a	RRI
ú mr t í	PRSS
ú sek ov ý	PRSI
ú smě v	PRS
ú spě ch	PRI
úst a	RI
úst i t	RSI
ú stup ek	PRI
úst í	RI
ú střed ní	PRS
ú střed í	PRS
ú trž ek	PRI
ú těš n ý	PRSI
ú zem í	PRS
úz k o	RSI
úz k ost	RSS
úz k ost n ě	RSSSI
ú čast	PR
ú čast en stv í	PRSSS
ú čast n i t	PRSSI
ú čin n ý	PRSI
ú řad	PR
ú řad ova t	PRSI
ú řed n í	PRSI
ú řed ník	PRS
ú řed n ě	PRSI
úž i t	RSI
čaloun i t	RSI
čaloun ova t	RSI
čap a t	RSI
čap nou t	RSI
čas	R
čas n ě	RSI
čas ova t	RSI
čas ov ě	RSI
čech iz ova t	RSSI
čechr a t	RSI
ček a t	RSI
ček á n í	RSSS
čel i t	RSI
čenich a t	RSI
čepejř i t	RSI
čep ova t	RSI
čepýř i t	RSI
čern i t	RSI
čern á	RI
čern ý	RI
čerp a t	RSI
čert	R
čert i t	RSI
červen	R
červen a t	RSI
červen ec	RI
červen i t	RSI
červen ý	RI
červen ě	RI
červ iv ě t	RSSI
čes a t	RSI
čes k o	RSI
čes k y	RSI
čes k ý	RSI
čest	R
čest n ý	RSI
čest n ě	RSS
čet a	RI
čet n ý	RSI
čeř i t	RSI
čeř iv ost	RSS
češ t in a	RSSI
čich	R
čich a t	RSI
čin	R
čin n ost	RSS
čin n ý	RSI
čin n ě	RSI
čist i t	RSI
čist ot a	RSI
čist ě	RI
člen	R
člen i t	RSI
človíč ek	RI
člověk	R
člán k ova t	RSSI
čmuch a t	RSI
čmuch nou t	RSI
čmár a t	RSI
čmár nou t	RSI
čp ě t	RSI
čtver ec	RI
čtver eč n í	RSSI
čtvrt i t	RSI
čtvrť	R
čuch a t	RSI
čuch nou t	RSI
čum ě t	RSI
čur a t	RSI
čvacht a t	RSI
čár a	RI
čár a t	RSI
čár k ova t	RSSI
čár ov ý	RSI
část	R
část eč n ě	RSSI
část ic e	RSI
část k a	RSI
číh a l	RSI
číh a t	RSI
čísl o	RI
čísl ova t	RSI
ďob a t	RSI
řad ic í	RSI
řad i t	RSI
řas i t	RSI
řed i t	RSI
řed i tel	RSI
řeht a t	RSI
řemesl n ý	RSI
řemesl o	RI
řev	R
řez a t	RSI
řez nic k y	RSSI
řez n ík	RSS
řeš en í	RSI
řid i č	RSS
řv á t	RSI
řád	R
řád i t	RSI
řád k ova t	RSSI
řád k ová n í	RSSSS
řád n ý	RSI
říc i	RI
říd i c í	RSSI
říd nou t	RSI
říd íc í	RSI
řík a t	RSI
říz en í	RSI
říz en ý	RSI
šach ov nic e	RSSI
šavl e	RI
šed in y	RSI
šed iv ě t	RSSI
šed ý	RI
šept a l	RSI
šept a t	RSI
šept nou t	RSI
šetř i t	RSI
šid i t	RSI
šifr ova n ý	RSSI
šifr ova t	RSI
šik nou t	RSI
šik ova t	RSI
šilh a t	RSI
šir oc e	RSI
šir ok o	RSI
šir ok ý	RSI
škatul k ova t	RSSI
škleb i l	RSI
škleb i t	RSI
škobrt nou t	RSI
škod a	RI
škod i t	RSI
škod ova t	RSI
škol en í	RSI
škol i t	RSI
škol n é	RSI
škol n í	RSI
škol ák	RS
škrob i t	RSI
škrt a t	RSI
škrt i l	RSI
škrt i t	RSI
škrt nou t	RSI
škub a t	RSI
škub nou t	RSI
škub nu t í	RSSI
škvař i t	RSI
škyt a t	RSI
škyt nou t	RSI
šlap a t	RSI
šlecht a	RI
šlecht i t	RSI
šleh á v a t	RSSSI
šláp nou t	RSI
šmajd a t	RSI
šmel i t	RSI
šmik nou t	RSI
šmodrch a t	RSI
šmudl a t	RSI
šněr ova t	RSI
šoup nou t	RSI
šour a t	RSI
španěl sk ý	RSI
špendl i t	RSI
šperk ova t	RSI
špik ova t	RSI
špin av ý	RSI
špin i t	RSI
špič at i t	RSSI
špič k a	RSI
špič k ova t	RSSI
šplh a dl o	RSSI
šplh nou t	RSI
šplouch a t	RSI
šplích a t	RSI
špon ova t	RSI
šprt a t	RSI
šprt k a	RSI
šprým ova t	RSI
šroub ova t	RSI
štv a n ec	RSSI
štíp a t	RSI
štíp nou t	RSI
štít	R
štěbet a t	RSI
štěk a t	RSI
štěk nou t	RSI
štěk nu t í	RSSI
štěk á n í	RSSS
štěp i t	RSI
štěp n ě	RSS
štěp ova t	RSI
štěst í	RI
šum	R
šum ě t	RSI
šust i t	RSI
švejk ova t	RSI
švih a t	RSI
švih nou t	RSI
švindl ova t	RSI
šíř e	RI
šíř i t	RSI
šíř k a	RSI
šňup a t	RSI
šňup nou t	RSI
šťast n ý	RSI
šťast n ě	RSI
šťouch a t	RSI
šťouch nou t	RSI
šťour a t	RSI
ťap a t	RSI
ťuk a t	RSI
ťuk nou t	RSI
žab ař	RS
žab í	RI
žad a tel	RSS
žad on i t	RSSI
žah a t	RSI
žal n ý	RSI
žal ova t	RSI
žebr a t	RSI
žebr o	RI
žebr on i t	RSSI
žebr ova t	RSI
žebr ák	RS
žeh a t	RSI
žehn a t	RSI
žeh nou t	RSI
želez n ý	RSI
želíz k o	RSI
žen a	RI
žen at ý	RSI
žen i ch	RSI
žen i t	RSI
žen sk ý	RSI
žert ova t	RSI
žert ov n ý	RSSI
žh av i t	RSSI
žh av ý	RSI
žh av ě t	RSSI
žh nou t	RSI
žh ář	RS
žid	R
žil k ova t	RSSI
žlout nou t	RSI
žlut i t	RSI
žlut ý	RI
žmol i t	RSI
žmoul a t	RSI
žr á t	RSI
žvatl a t	RSI
žvýk a t	RSI
žáb a	RI
žád a t	RSI
žád ost	RS
žád ou c í	RSSI
žíh a t	RSI
adres a	RI
andíl ek	RI
anděl í	RI
anim ova t	RSI
baf nou t	RSI
bagr ova t	RSI
bal en í	RSI
bav i t	RSI
blb ec	RI
bour a t	RSI
bouč ek	RI
bud ouc í	RSI
bydl e n í	RSSI
báb a	RI
bíl e	RI
bý v a l ý	RSSSI
břich at ě t	RSSI
centr ál a	RSI
centr ální	RS
centr ál n ě	RSSI
cest ov á n í	RSSSS
chalup a	RI
charakter	R
charakter ist ik a	RRSI
chlad i t	RSI
chlaz en ý	RSI
chláp ek	RI
chop i t	RSI
cht í t	RSI
chyb a	RI
cink nou t	RSI
cit át	RS
ciz í	RI
cour a	RI
ct í t	RSI
cíl en ě	RSI
daň	R
de sign ova t	PRSI
dimenz e	RI
dlaž b a	RSI
dlouž i t	RSI
dluž n ý	RSI
dobr o	RI
do bád a t	PRSI
dobř e	RI
do hlíd a t	PRSI
do hn a t	PRSI
do hád a t	PRSI
do loud a t	PRSI
dol ova t	RSI
dom ek	RI
do mák nou t	PRSI
do pad á v a t	PRSSSI
do plat i t	PRSI
do plav a t	PRSI
do po ruč en í	PPRSI
do stač ova t	PRSI
do střik ova t	PRSI
do syt i t	PRSI
do sáh nou t	PRSI
do taz	PR
do taz ník	PRS
do tlouc i	PRI
do tvář e t	PRSI
do tyč n ý	PRSI
do táz a n ý	PRSSI
do tír a t	PRSI
do tř í t	PRSI
do vol en á	PRSI
do zn í v á n í	PRSSSSS
do řek nou t	PRSI
do ší t	PRI
do žád a t	PRSI
do ží v a t	PRSSI
drt i č	RSS
drž e n í	RSSI
duš en ě	RSI
dvůr	R
dír a	RI
dých a t	RSI
děl nic e	RSI
dět in stv í	RSSS
dů chod ov ý	PPPI
figur ova t	RSI
film ova t	RSI
financ ova t	RSI
finanč n ě	RSS
form ova t	RSI
has i t	RSI
has i č	RSS
hlav at ý	RSI
hliň ák	RS
hloub	R
hlub ok ý	RSI
hluč n ý	RSI
hnět en í	RSI
hod i t	RSI
hoj i t	RSI
hoj n ě	RSI
hor ák	RS
hospod ář	RS
host in sk ý	RSSI
hrab a t	RSI
hrb at i t	RSSI
hrub ý	RI
hrub ě	RI
jádr o	RI
jízd en ka	RSI
kap a t	RSI
kapes n íč ek	RSSI
kapitál ov ě	RSI
kas a t	RSI
kaz a tel	RSS
kec nou t	RSI
keř	R
klad iv o	RSI
kles a t	RSI
klid n ě	RSI
klič k ova t	RSSI
klopýt nou t	RSI
klouz nou t	RSI
klíč n í	RSI
knih a	RI
kolís a t	RSI
kol íč k ova t	RSSSI
kombin ova t	RSI
koneč n ý	RSI
kontrol ová n í	RSSS
kon á n í	RSSS
konč i t	RSI
kouk nou t	RSI
koum a t	RSI
koup ac í	RSI
kož eš in ov ý	RRSSI
král	R
krám ova t	RSI
krás n ý	RSI
káp nou t	RSI
kých a t	RSI
kýv nou t	RSI
křest	R
křt í t	RSI
lak ova t	RSI
led nic ovit ý	RSSI
led ov at ě t	RSSSI
les	R
let ě t	RSI
lh á t	RSI
lid	R
lid sk ý	RSI
liš i t	RSI
loup ež	RS
lyž ař	RS
lék ař sk ý	RSSI
líst eček	RS
lít o	RI
líz nou t	RSI
magnet	R
mal ý	RI
map ka	RI
mar n i t	RSSI
mek a t	RSI
minister stv o	RSI
model ova t	RSI
modul ova t	RSI
motiv	R
muzik ant	RS
muzik ant sk ý	RSSI
muž stv o	RSI
myš	R
mín it	RI
mín ěn ý	RSI
měd i t	RSI
měk k o	RSI
měk č i t	RSSI
měř en í	RSI
měř i t	RSI
mříž ova t	RSI
mříž ov ec	RSI
na bloud i t	PRSI
na checht a t	PRSI
na chyl ova t	PRSI
na dou v a t	PRSSI
nad zdvih ova t	PRSI
na hlas	PR
na hlod á v a t	PRSSSI
na hod i t	PRSI
na kaz ova t	PRSI
na kaž li v ý	PRRSI
na krout i t	PRSI
na kus ova t	PRSI
na kuř ova t	PRSI
na léz t	PRI
na plň ova t	PRSI
na pích á v a t	PRSSSI
na soud i t	PRSI
na stá v a t	PRSSI
na stěh ova t	PRSI
na tah a t	PRSI
na třísk a t	PRSI
na vaz ová n í	PRSSS
na vrch	PR
na vrh nou t	PRSI
na vrš i t	PRSI
na véz t	PRI
na víj e t	PRSI
na věš ova t	PRSI
na čich nou t	PRSI
na řík a t	PRSI
na šept á v a t	PRSSSI
na škub a t	PRSI
na šňup nou t	PRSI
na žert ova t	PRSI
ne bý v a l e	IPPPPI
ne jas n ý	IRSI
ne po zor ova n ost	IPRSSS
ne ruš en ě	IRSS
noc ova t	RSI
nouz e	RI
novel a	RI
nov áč ek	RSI
nuc en ě	RSI
nut n ost	RSS
ná jem	PR
ná jezd	PR
ná skok	PR
ná sled ov n ě	PRSSI
ná sled uj íc í	PRSSI
ná zev	PR
ná znak	PR
obec n ě	RSI
ob jedn a t	PRSI
ob je t	PRI
ob měk č ova t	PRSSI
ob naž i t	PRSI
ob nov i t	PRSI
o brous i t	PRSI
ob ráž e t	PRSI
ob star á v a t	PRSSSI
ob tíž n ě	PRSI
ob vaz ova t	PRSI
o bydl e t	PRSI
o by v a tel stv o	PRSSSSI
ob čas	PR
obět ova t	RSI
ob šláp nou t	PRSI
o chod i t	PPPI
o chur av ě t	PRSSI
od barv ova t	PRSI
od brzď ova t	PRSI
ode t nou t	PPPI
od hrab ova t	PRSI
od je t	PRI
od kap á v a t	PRSSSI
od klop i t	PRSI
od koléb a t	PRSI
od kop nou t	PRSI
od káp nou t	PRSI
od káz a t	PRSI
od lí v a t	PRSSI
od měn a	PRI
od měn i t	PRSI
od ním a t	PRSI
od oper ová v a t	PRSSSI
od po věd ě t	PPRSI
od pud i t	PRSI
od pár a t	PRSI
od při sáh nou t	PPRSI
od raz	PR
od ruš i t	PRSI
od sed ě t	PRSI
od straš i t	PRSI
od strč i t	PRSI
od trh a t	PRSI
od trh á v a t	PRSSSI
o dus i t	PRSI
od vol a t	PRSI
od vol i t	PRSI
od váb i t	PRSI
od řez a t	PRSI
od říz nou t	PRSI
od špendl i t	PRSI
o hlaz ova t	PRSI
o hmat á v a t	PRSSSI
o hrom n ý	PRSI
o hrom n ě	PRSI
o hryz á v a t	PRSSSI
o hří v a t	PRSSI
o klam a t	PRSI
o kol í	PRS
o krád a t	PRSI
o křik nou t	PRSI
o mdl é v a t	PRSSSI
o mez i t	PRSI
o myl	PR
o ploz ova t	PRSI
o po vrh ova t	PPRSI
o po vrž liv ě	PPRSI
o prac ova t	PRSI
o praž i t	PRSI
o slep nou t	PRSI
o tes a t	PRSI
o tup ova t	PRSI
o vad nou t	PRSI
o zlat i t	PRSI
o čenich a t	PRSI
o čes á v a t	PRSSSI
o řez á v a t	PRSSSI
o říz nou t	PRSI
o škub á v a t	PRSSSI
o ší v a t	PRSSI
pan	R
pan ičk a	RSI
pat a	RI
patr n ě	RSS
paž i t	RSI
pejs án ek	RSI
peč l iv ě	RSSI
plac en ý	RSI
plod i t	RSI
plod n ost	RSS
plot	R
plán ova t	RSI
plýtv a t	RSI
po bruč ova t	PRSI
po by t	PRI
po chlub i t	PRSI
po chop i teln ě	PRSSI
po chyt i t	PRSI
pod ceň ova t	PRSI
pode zd í v a t	PRSSSI
pod lom i t	PRSI
pod mal ova t	PRSI
pod miň ova t	PRSI
pod nik a tel	PRSS
pod pír a t	PRSI
pod sek nou t	PRSI
pod ték a t	PRSI
po děl a n ý	PRSSI
po děl i t	PRSI
pod řez á v a t	PRSSSI
po dřim ova t	PRSI
po hromad ě	PRI
po hrá v a t	PRSSI
po hvizd ova t	PRSI
po hřb í v a t	PRSSSI
po jist i t	PRSI
po jist n é	PRSI
po jišť ovn a	PRSI
po jíd a t	PRSI
po kašl á v a t	PRSSSI
po kles nou t	PRSI
po kláp ě t	PRSI
po křiž ova t	PRSI
po křt í t	PRSI
po loh a	PRI
po lož i t	PRSI
po líč i t	PRSI
po mlask á v a t	PRSSSI
po moc i	PRI
po muchl ova t	PRSI
po měr	PR
po mř í t	PRSI
po ob vesel i t	PPRSI
po po je t	PPRI
po po strk ova t	PPRSI
po po táh nou t	PPRSI
po pt á v k a	PRSSSI
po přá v a t	PRSSI
po rad i t	PRSI
po rad k yn ě	PRSSI
po rovn a t	PRSI
portrét ova t	RSI
po skyt uj íc í	PRSSI
po soud i t	PRSI
po sr á v a t	PRSSSI
po star a t	PRSI
po stá v a t	PRSSI
po stýsk á v a t	PRSSSI
po střel i t	PRSI
potenc iál n í	RSSI
po trat i t	PRSI
po trav in ář sk ý	PRSSSI
po tír a t	PRSI
po třeb a	PRI
po třás t	PRI
po uč en í	PRSI
poušt n í	RSI
pouť	R
po u ží v a n ý	PPRSSSI
po val ova t	PRSI
po vol i t	PRSI
po vrh ova t	PRSI
po vy stoup i t	PPRSI
po vy tah ova t	PPRSI
po vy táh nou t	PPRSI
po vz dech nou t	PPRSI
po vz dych ova t	PPRSI
po za vír a t	PPRSI
po zdrav i t	PRSI
po zor n ost	PRSS
po zor n ě	PRSI
po zor ová n í	PRSSS
po řád a t	PRSI
po šept a t	PRSI
po škoz en í	PRSI
po šlap a t	PRSI
po šlap á v a t	PRSSSI
po ší t	PRI
po žad a v ek	PRSSI
po žád a t	PRSI
prac ov n a	RSSI
prac ov nic e	RSSI
pras e č i t	RSSSI
prezent ac e	RSI
prezent ova t	RSI
pro bád a t	PRSI
pro debat ova t	PRSI
pro hloub i t	PRSI
pro hmat a t	PRSI
pro hrab a t	PRSI
pro hráb nou t	PRSI
pro hří v a t	PRSSI
pro jedn á v á n í	PRSSSSS
pro klouz á v a t	PRSSSI
pro kmit a t	PRSI
pro kuř ova t	PRSI
pro mar n i t	PRSSI
pro maz á v a t	PRSSSI
pro mrsk a t	PRSI
pro ná jem	PPR
pro pr a t	PRSI
pro pás t	PRI
pro pék a t	PRSI
pro tanč i t	PRSI
pro trh nou t	PRSI
pro trh á v a t	PRSSSI
pro ték a t	PRSI
pro véz t	PRI
pro říz nou t	PRSI
prýsk a t	RSI
prů mysl	PR
ps a n í	RSSI
páj e t	RSI
pár	R
péč e	RI
pích nou t	RSI
písk ova t	RSI
pě t	RI
pře brous i t	PRSI
pře buj e t	PRSI
pře cez ova t	PRSI
pře chýl i t	PRSI
pře cvič i t	PRSI
přede pis ova t	RRSI
před n ost	RSS
před náš e t	PRSI
před n ě	PPI
před paž i t	PRSI
před po věd ě t	PPRSI
před vol a t	PRSI
pře hmát nou t	PRSI
pře hobl ova t	PRSI
pře jís t	PRI
pře kap a t	PRSI
pře kom pon ova t	PRRSI
pře kořen i t	PRSI
pře kruc ova t	PRSI
pře křik nou t	PRSI
pře křik ova t	PRSI
pře křt í t	PRSI
pře let ě t	PRSI
pře most i t	PRSI
pře mož i tel	PRSS
pře máh a t	PRSI
pře pad nou t	PRSI
pře plác a t	PRSI
pře pál i t	PRSI
pře ruš ova t	PRSI
pře sch nou t	PRSI
pře straš i t	PRSI
pře tah ova t	PRSI
pře tř í t	PRSI
pře uč i t	PRSI
pře val ova t	PRSI
pře vlád nou t	PRSI
pře ví v a t	PRSSI
pře zou v a t	PRSSI
pře čerp a t	PRSI
pře škol en í	PRSI
pře šlap a t	PRSI
při barv ova t	PRSI
při chýl i t	PRSI
při drž e t	PRSI
při drž ova t	PRSI
při děl á v a t	PRSSSI
při frč e t	PRSI
při hlás i t	PRSI
při hrá v a t	PRSSI
při ház e t	PRSI
při klep á v a t	PRSSSI
při kom pon ova n ý	PRRSSI
při koul e t	PRSI
při krý t	PRI
při kup ova t	PRSI
při káz á n í	PRSSS
při lét á v a t	PRSSSI
při léz t	PRI
při lí t	PRI
při nož ova t	PRSI
při náš e t	PRSI
při pevn i t	PRSI
při plíž i t	PRSI
při pál i t	PRSI
při pích nou t	PRSI
při stroj i t	PRSI
při stup ova t	PRSI
při sun ova t	PRSI
při tisk nu t ý	PRSSI
při táh nou t	PRSI
při těž uj íc í	PRSSI
při uč i t	PRSI
při vaz ova t	PRSI
při věs i t	PRSI
při zn a t	PRSI
při čich nou t	PRSI
při čin ěn í	PRSI
při šoup nou t	PRSI
přís t	RI
pří štip k ova t	PRSSI
půjč ova t	RSI
radikál n ě	RSI
real it n í	RSSI
relac e	RI
relat ivn ě	RSI
roz brázd i t	PRSI
roz buj n ě t	PRSSI
roz cuch a t	PRSI
roz drb a t	PRSI
roz díl e t	PRSI
roz děl ova t	PRSI
roze rv a t	PRSI
roz has i t	PRSI
roz hněv a t	PRSI
roz host i t	PRSI
roz houk á v a t	PRSSSI
roz hr nou t	PRSI
roz ház en ý	PRSI
roz hřeš i t	PRSI
roz kaz ova t	PRSI
roz kmit a t	PRSI
roz kop á v a t	PRSSSI
roz kýv a t	PRSI
roz lam ova t	PRSI
roz loup á v a t	PRSSSI
roz lé v a t	PRSSI
roz moc i	PRI
roz mrz e t	PRSI
roz máz nou t	PRSI
roz měk nou t	PRSI
roz por	PR
roz prch a t	PRSI
roz pě t í	PRSS
roz půl i t	PRSI
roz svěc e t	PRSI
roz tanc ova t	PRSI
roz tep á v a t	PRSSSI
roz trh nou t	PRSI
roz ték a t	PRSI
roz těk á v a t	PRSSSI
roz um ová n í	PRSSS
roz vař i t	PRSI
roz vesel ova t	PRSI
roz vikl a t	PRSI
roz vléc i	PRI
roz vlň ova t	PRSI
roz víř i t	PRSI
roz věš e t	PRSI
roz čar ova t	PRSI
roz čechr á v a t	PRSSSI
roz řad i t	PRSI
roz škrt nou t	PRSI
rám ova t	RSI
rýp nou t	RSI
s bal ova t	PRSI
s chov a t	PRSI
s chvál n ě	PRSI
s děl a t	PRSI
s děl ová n í	PRSSS
se hn a t	PRSI
se hrá v a t	PRSSI
se sch nou t	PRSI
se skak ova t	PRSI
se steh ova t	PRSI
se řez á v a t	PRSSSI
se šlap á v a t	PRSSSI
se šněr ova t	PRSI
s hled a n á	PRSSI
s ház e t	PRSI
sil n ič n í	RSSSI
s jedn a t	PRSI
s kap á v a t	PRSSSI
s klad	PR
skl en ář sk ý	RSSSI
s klid i t	PRSI
s klič ova t	PRSI
s kon a t	PRSI
s kop a t	PRSI
skák a t	RSI
sled	R
s los ova t	PRSI
s los ová n í	PRSSS
s loup á v a t	PRSSSI
s lož en í	PRSI
sluš e t	RSI
slíd i t	RSI
slých a t	RSI
s mršť ova t	PRSI
s mysl i t	PRSI
s mích á v a t	PRSSSI
s nís t	PRI
sn í t	RSI
s nýt ova t	PRSI
sněž i t	RSI
soud c e	RSI
s pln ěn í	PRSI
s plác nou t	PRSI
sport	R
s po třeb a	PPPI
s po třeb ová v a t	PPRSSSI
s péc i	PRI
s rovn á v á n í	PRSSSSS
s tah a t	PRSI
star ý	RI
s tisk a t	PRSI
strach	R
stroj n í	RSI
strouh nou t	RSI
stá v a t	RSSI
svobod a	RI
s vol i t	PRSI
svět sk ý	RSI
symbol iz ova t	RSSI
síl i t	RSI
s říz nou t	PRSI
tanč i t	RSI
test ova t	RSI
tlak	R
totál n í	RSI
trumf ova t	RSI
trysk ov ý	RSI
trén ova t	RSI
trž i t	RSI
trž n ě	RSI
tuž b a	RSI
tvrd ě	RI
téc i	RI
třep a t	RSI
tříb i t	RSI
tř í t	RSI
u cp a t	PRSI
u has nou t	PRSI
u hlad i t	PRSI
u hřá t	PRI
u kamen ova t	PRSI
u kořist ěn ý	PRSI
u krát i t	PRSI
u lam ova t	PRSI
ulič k a	RSI
u lí v a t	PRSSI
u met a t	PRSI
u mř í t	PRSI
u nos i t	PRSI
u nés t	PRI
u pad nou t	PRSI
u pín a t	PRSI
u raz i t	PRSI
u skak ova t	PRSI
u skoč i t	PRSI
u smol i t	PRSI
u s mysl i t	PPRSI
u stá v a t	PRSSI
u tlesk a t	PRSI
u t nou t	PPPI
u vid ě t	PRSI
u za vř í t	PPRSI
u zn a t	PRSI
u zn á v aj íc í	PRSSSSI
u zá kon i t	PPRSI
u čar ova t	PRSI
u šetř i t	PRSI
u šlap a t	PRSI
u štip ova t	PRSI
vad a	RI
v bod á v a t	PRSSSI
ven	R
ven k ov	RSS
ven k ovn í	RSSI
verš	R
verš ova t	RSI
vesel i t	RSI
ves nic k ý	RSSI
vidl ic e	RSI
vid ě t	RSI
v kap á v a t	PRSSSI
v klad	PR
v káp nou t	PRSI
vlast n ost	RSS
vlh nou t	RSI
vlád a	RI
vláč n ě t	RSSI
v lí v a t	PRSSI
vol b a	RSI
von ě t	RSI
v prav ova t	PRSI
vrz a t	RSI
vrš i t	RSI
v souk a t	PRSI
v tlouk a t	PRSI
v trh nou t	PRSI
vy baf nou t	PRSI
vy barv i t	PRSI
vy bav i t	PRSI
vy blýsk nou t	PRSI
vy buch nou t	PRSI
vy cuc nou t	PRSI
vy doj i t	PRSI
vy draž i t	PRSI
vy děl a t	PRSI
vy fouk nou t	PRSI
vy gum ova t	PRSI
vy hled a t	PRSI
vy hod i t	PRSI
vy hrab a t	PRSI
vy hrab ova t	PRSI
vy hrab ová n í	PRSSS
vy hrab á v a t	PRSSSI
vy jev ova t	PRSI
vy jmen ova t	PRSI
vy kous a t	PRSI
vy kram ař i t	PRSSI
vy krop i t	PRSI
vy kul i t	PRSI
vy kvés t	PRI
vy káp nou t	PRSI
vy křič e t	PRSI
vy los ova t	PRSI
vy louh ova t	PRSI
vy mačk á v a t	PRSSSI
vy mír a t	PRSI
vy mý v a t	PRSSI
vy měř ova t	PRSI
vy na jí t	PPRI
vy plav a t	PRSI
vy plav i t	PRSI
vy plň ova t	PRSI
vy po slech nou t	PPRSI
vy po řád á v a t	PPRSSSI
vy pék a t	PRSI
vy rýp á v a t	PRSSSI
vy růst a t	PRSI
vy sek a n ý	PRSSI
vy sek á v a t	PRSSSI
vy sn í t	PRSI
vys oc e	RRI
vy strk a t	PRSI
vy stup ová n í	PRSSS
vy stá t	PRI
vy tah a n ý	PRSSI
vy trub ova t	PRSI
vy trv a t	PRSI
vy trén ova t	PRSI
vy tvoř i t	PRSI
vy uč en í	PRSI
vy vol á v a c í	PRSSSSI
vy véz t	PRI
vy víj e t	PRSI
vy věs i t	PRSI
vy zdvih nou t	PRSI
vy zim ova t	PRSI
vy zlat i t	PRSI
vy zob nou t	PRSI
vy čišt ěn ý	PRSI
vy řaď ova t	PRSI
vy řeš i t	PRSI
vy řít i t	PRSI
vy říz en ý	PRSI
vy šetř en í	PRSI
vy šetř i t	PRSI
vy šetř ová n í	PRSSS
vy šperk ova t	PRSI
vy žad ova t	PRSI
vy žr a t	PRSI
vz buz ova t	PRSI
vz dou v a t	PRSSI
vz pla nou t	PRSI
vz ruš e n ě	PRSSI
vý děl ek	PRI
vý křik	PR
vý rob n a	PRSI
vý uk a	PRI
věr n ě	RSI
větr a t	RSI
všim nou t	RSI
v šoup nou t	PRSI
za barv i t	PRSI
za barv ova t	PRSI
za blok ova t	PRSI
za bloud i t	PRSI
za bouch a t	PRSI
za checht a t	PRSI
za clán ě t	PRSI
za dlab a t	PRSI
za drát ova t	PRSI
za drž e t	PRSI
za dých a t	PRSI
za han b ova t	PRSSI
za hnízd i t	PRSI
za hrab á v a t	PRSSSI
za hryz á v a t	PRSSSI
za hák nou t	PRSI
za jišť uj íc í	PRSSI
za jím a t	PRSI
za jím a v ost	PRSSS
za jížd ě t	PRSI
za klič k ova t	PRSSI
za klon i t	PRSI
za klán ě t	PRSI
za koup en í	PRSI
za lam ova t	PRSI
za lét á v a t	PRSSSI
za lí v a t	PRSSI
za maz á v a t	PRSSSI
za mlask a t	PRSI
za mlč e t	PRSI
za modr a t	PRSI
za mysl i t	PRSI
za měn i t	PRSI
za ostř i t	PRSI
za paž ova t	PRSI
za plň ova t	PRSI
za pušt ěný	PRR
za pách a t	PRSI
za rost l ý	PRSI
za sek nou t	PRSI
za skl í t	PRSI
za smrk a t	PRSI
za smá t	PRI
za sol i t	PRSI
za stl a t	PRSI
za stud i t	PRSI
za sun ova t	PRSI
za svět él k ova t	PRSSSI
za taj ova t	PRSI
za tmel i t	PRSI
za tm í t	PRSI
za téc i	PRI
za těk a t	PRSI
za va nou t	PRSI
za vař i t	PRSI
za vikl a t	PRSI
za vod ň ova t	PRSSI
za vrh nou t	PRSI
za vrh ova t	PRSI
za váz a t	PRSI
za véz t	PRI
za zář i t	PRSI
za čar ova t	PRSI
za čp ě t	PRSI
za řeht a t	PRSI
za řez a t	PRSI
za říz nu t ý	PRSSI
za škleb i t	PRSI
za škol ová n í	PRSSS
za štíp a t	PRSI
za žal ova t	PRSI
za žeh nou t	PRSI
za žád a t	PRSI
z běl e t	PRSI
z chud nou t	PRSI
z chyst a t	PRSI
z ciz i t	PRSI
z dan ěn í	PRSI
zdrav ot nic k ý	RSSSI
z dřev ěn ě t	PRSSI
zelen i t	RSI
zem ě	RI
ze mř í t	PRSI
ze smut n ě t	PRSSI
ze stár nou t	PRSI
z film ova t	PRSI
z hlt a t	PRSI
z jedn a t	PRSI
z jedn á v a t	PRSSSI
z jev ova t	PRSI
z kap a t	PRSI
z kruš i t	PRSI
z kuš eb n í	PRRSI
z lid št ě t	PRSSI
z mechan iz ova t	PRRSI
z mls a t	PRSI
z mám i t	PRSI
z měk č i t	PRSSI
z měn i t	PRSI
z ne svěc ova t	PIRSI
z ne u zn á v á n í	PIPRSSSSS
z ne čisť ová n í	PIRSSS
z ne čišť uj íc í	PIRSSI
z ne škod n i t	PIRSSI
zob ák	RS
zob á n í	RSSS
z od po věd ě t	PPPRSI
z orient ova t	PRSI
zouf nou t	RSI
z plesn iv ě t	PRSSI
z popel ň ova t	PRSSI
z pře ráž e t	PPRSI
z pře vrac ova t	PPRSI
zrn k o	RSI
z rub a t	PRSI
z rýh ova t	PRSI
z růž ov ě t	PRSSI
z tav i t	PRSI
z tm av ě t	PRSSI
z trac en o	PRSI
z trh nou t	PRSI
z tvrd nou t	PRSI
z třísk a t	PRSI
z u ráž e t	PPRSI
z verš ova t	PRSI
z vikl á v a t	PRSSSI
z vyš ova t	PRSI
zád a	RI
zá jem c e	PRSI
zá vid ě t	PRSI
zá vrať	PR
z ú čast ň ova t	PPRSSI
z řek nou t	PRSI
z řez a t	PRSI
z říd i t	PRSI
z šed iv ě t	PRSSI
ú hlav n í	PRSI
ú čast ník	PRS
ú čin n ě	PRSI
čad i t	RSI
čar ova t	RSI
čel o	RI
čet n ík	RSS
čist ý	RI
člán ek	RI
řad a	RI
řeč n i t	RSSI
řeš i teln ý	RSSI
říd k ý	RSI
říz nou t	RSI
šerm ova t	RSI
škobrt a t	RSI
šleh nou t	RSI
šmik a t	RSI
šoup á n í	RSSS
špič k ov ý	RSSI
šplích nou t	RSI
šíp	R
ťap k a t	RSSI
žvan i t	RSI
adapt abil n í	RSSI
bal en ý	RSI
bok	R
box	R
bud ova	RS
cen ík	RS
chléb	R
chrán i t	RSI
chyb ěj íc í	RRSI
cháp a t	RSI
couv nou t	RSI
div ák	RS
do drž ová n í	PRSSS
do hromad y	PRI
do plac en í	PRSI
do pln i t	PRSI
do plác e t	PRSI
do po máh a t	PPRSI
děl en í	RSI
dů chod	PP
falš ova t	RSI
funkč n í	RSI
gener ac e	RSI
hlad	R
hud eb n í	RSSI
in form ova t	RRSI
jedn ot liv in a	RRSSI
kles aj íc í	RSSI
kost n í	RSI
kraj	R
krv av ě t	RSSI
kry t ý	RSI
krám	R
kup uj íc í	RSSS
kšeft	R
let išt ě	RSI
limit	R
líst ek	RI
mal ič k ý	RSSI
mast	R
maz á n í	RSSS
meč e n í	RSSI
mil ost	RS
min ul ý	RSI
mluv íc í	RSI
mont áž	RS
míst n í	RSI
na by t í	PRSI
na dš en í	PRSI
na kol k ova t	PRSSI
na vy práv ě t	PPRSI
ne moc n ý	IRSI
ne štěst í	IRI
nul a	RI
ná by tek	PRR
ná stroj	PR
návštěv a	RI
návštěv n ost	RSS
ob sah uj íc í	PRSSI
o chran k a	PRSI
od chyl k a	PRSI
od lož en í	PRSI
od po víd a t	PPRSI
od řík a t	PRSI
od štěp ova t	PRSI
o hlod a t	PRSI
o mez ová n í	PRSSS
o plod ň ova t	PRSSI
o sp a l ost	PRSSS
o svoboz en í	PRSI
ote vř í t	RRSI
o trav ova t	PRSI
o vlád á n í	PRSSS
o ví t	PRI
o věř i t	PRSI
pan en k a	RSSI
peníz	R
plac en í	RSI
plat b a	RSI
pln ěn í	RSI
po klad	PR
po klep a t	PRSI
po krout i t	PRSI
po plat ník	PRS
po rovn ání	PRS
po stih	PR
po suz ová n í	PRSSS
po síl en í	PRSI
po vz dych nou t	PPRSI
po víd k a	PRSI
po čas í	PRS
po řad a tel	PRSS
po řád á n í	PRSSS
pro duc ent	PRR
pro děl a t	PRSI
pro děl ek	PRI
pro hlíž e t	PRSI
pro klábos i t	PRSI
pro lam ova t	PRSI
propag ac e	RSI
pro trh a t	PRSI
práv e m	RSI
práv o	RI
prů běh	PP
prů mysl ov ě	PRSI
pump nou t	RSI
pách a t	RSI
před cház e t	PPPI
před lož i t	PRSI
před vý rob n í	PPRSI
pře hrad a	PRI
pře roub ova t	PRSI
přesn ost	RS
pře střel i t	PRSI
při cház e t	PPPI
při vy děl á v a t	PPRSSSI
pří zem í	PRS
rad a	RI
roh áč ek	RSI
roz drt i t	PRSI
roz děl en í	PRSI
roz hlas	PR
roz jížd ě t	PRSI
roz lož i t	PRSI
roz mot a t	PRSI
roz paž i t	PRSI
roz prask nou t	PRSI
roz šiř ová n í	PRSSS
ruč k ova t	RSSI
rán a	RI
různ ě	RI
s bratř i t	PRSI
scén a	RI
sek nou t	RSI
se strk á v a t	PRSSSI
s kas a t	PRSI
s konč en í	PRSI
slav n ost n ě	RSSSS
sled ová n í	RSSS
slun c e	RSI
slyš e t	RSI
sou boj	PR
sou vis l ost	PRSS
s pln i t	PRSI
sport ov n í	RSSI
s po třeb i tel	PPRSR
s roz um i teln ě	PPRSSI
stabil n í	RSI
star a t	RSI
star ob n í	RSSI
start	R
sta v en í	RSSI
s trav a	PRI
stud ent	RR
stud ij n í	RSSI
stud ova n ý	RSSI
stůl	R
super dobr ý	PRI
svět ov ě	RSI
system at ic k ý	RSSSI
techn ik a	RRI
tip nou t	RSI
trž b a	RSI
táh l o	RSI
týr a t	RSI
u jist i t	PRSI
u lov i t	PRSI
u plat i t	PRSI
u pích a t	PRSI
urč it ě	RSS
uč i tel	RSS
u žmoul a t	PRSI
u ží v a t	PRSSI
večer	R
v mysl i t	PRSI
v stup	PR
v stup enk a	PRSI
v stup n é	PRSI
vy drážd i t	PRSI
vy dých nou t	PRSI
vy na lož i t	PPRSI
vy pro vok ova t	PPRSI
vys ok á	RSI
vy sp ink a t	PRSSI
vy stoup en í	PRSI
vy stoup i t	PRSI
vy síl a c í	PRSSI
vy z vrac e t	PPRSI
vy řík a t	PRSI
vz děl án í	PRSS
válk a	RI
vítěz ství	RS
větr ovk a	RSI
za houk a t	PRSI
za hr nu t í	PRSSI
za jist i t	PRSI
za kop a n ý	PRSSI
za kýv a t	PRSI
za mal ova t	PRSI
za perl i t	PRSI
za syp a n ý	PRSSI
za věš en í	PRSI
z dřev n at ě t	PRSSSI
z falš ová n í	PRSSS
z jist i t	PRSI
z kouš e t	PRSI
z modr a t	PRSI
z pě v a č k a	PRSSSSI
z ruš en í	PRSI
z vrát i t	PRSI
zá sob en í	RRSI
zá sob ová n í	RRSSS
zá stup c e	PRRI
ú prav a	PRI
ú čast n ě	PRSI
čin i t	RSI
čtvrt	R
řez á n í	RSSS
řeš i t	RSI
řád n ě	RSI
šed iv ý	RSI
škol a	RI
žehl i t	RSI
