kn k y	RII
 as n ho	PRSI
sedm i len n ou	RIRSI
se t  t	PRII
tht a	RI
v t ov 	PRSI
zdrav	R
styd nou t	RII
ne kdk a l y	PRISI
bez vad n ch	RRSI
po krok em	PRI
n klad ov ch	PRSI
do sta ne	PRS
obd	R
u klid n i l i	PRSISI
z jem ova t	PRII
pi mch  v a t	PRSSII
pi prav i t	PRII
fabk a	RI
s tr i t	PRII
mini stran y	RRI
vy v d a t	PPRII
z lom i t	PRII
brept a t	RII
kabel	R
 tok u	PRS
ze patn  t	PRII
pol ovi n 	RISI
tak ov ou	RSI
po cvi i t	PRII
na ts a t	PRII
zunk nou t	RII
o pd a t	PRII
ne vy hr t	PPRI
belh a t	RII
prc e s chop n 	RISRSI
nymf a	RI
ne roz trh a l i	PPRISI
o lam ova t	PRII
po t u	PRS
zl e	RI
pro cvik a n 	PRISI
senz ac e	RSI
u i v a tel e	PRSISI
slov y	RI
pod rob i t	PRII
tlak em	RI
po prsk a t	PRII
z pozd i t	PRII
in fekc e	PRI
na cuc a t	PRII
nej akt iv n j 	PRSSII
na zu l	PRS
s klad ov 	PRSI
z re duk ova t	PPRII
thai box er	RRR
jin mi	RI
ma	R
tych	R
ne roz li uje	PPRR
roz pn a t	PRII
jedn a dv a ct k a	RIRIRII
br  t	PPI
u rp nou t	PRII
post pozic e	RRI
z ne klid  ova t	PPRSII
rat ing	RR
z kyp e t	PRII
druh m	RR
vy hlaz ova t	PRII
jabl k a	RSI
pe syp a t	PRII
rut ov	RS
var	R
pro dch nou t	PRII
ne pod daj n 	PPRSI
s kon i l a	PRISI
o hod n ot i t	PRSSII
do tvrd i t	PRII
obe e l	PRS
sh l a	RSI
otrok ov ic e	RSSI
ir ok y	RII
znam en aj 	RSSI
d vr ch	PRR
mr u mil ov n 	RSRSSI
ne m  l y	PIIPI
nej bd n j mu	PRSIR
pytl c i	RSI
bass re flex	RSR
ob t i t	PRII
po koz en 	PRSI
kd o 	PPR
florin 	RS
prakt ic k 	RSIS
koberc e	RI
n kolik a d k ov ho	RRIRISI
pi in n 	PRSI
svt 	RI
ne s mr n ou	PPRSI
ti	R
en a	RI
ped mi nu l ho	PRSSI
chytr k	RS
od je t	PRI
u r it ost	PRIS
sma en ch	RSI
pedant ism u	RRS
bidl a	RI
blaf nou t	RII
cykl o kros u	RSRS
zl ost i	RSI
ran 	RI
vz duch o ventil ac e	PRSRSI
o hryz  v a t	PRSSII
vlk ou	RI
kred it ova t	RIII
pi s v a t	PRSII
popo sad i t	PRII
katolic k 	RII
inter ven ova l a	RRISI
ne obyej n 	PRSI
armstrong	R
krucembur sk 	RII
rd  t	RII
lod ik a	RSI
hrab a l	RIS
pe vaz ova t	PRII
strach em	RI
shakespear o mani e	RSRI
brabec	R
v nos u	PRS
lesk l i	RSI
s chz  te	PPIR
vete nk	RS
z po ova t	PRII
po teb ova l i	PRISI
pi prav en ho	PRSI
pe ns t	PRI
inaugur ov n	RSS
re sign ova t	PRII
gener l	RI
u vd om i l	PRRIS
rod in ch	RSR
v d 	PRI
sp a t	RII
garanc e	RI
helfr	R
u sm v a l	PRSIS
ochot a	RI
dluh y	RI
kapitn ovi	RR
chc e me	RIR
pin 	RS
ber e	RI
ln	R
o krb a t	PRII
po do tk a ti	PPRIR
