adapt ova t	RII
adres ova t	RII
agit ova t	RII
akc e	RI
a klim at iz ova t	IRSSII
alkohol	R
alkohol ik	RS
americ k y	RII
americ k ý	RII
amerik a	RI
amerik an iz ova t	RSSII
amerik án stv í	RSSI
anděl	R
angl ick y	RII
angl ick ý	RII
angl ič an	RSS
aranž ova t	RII
argument	R
asfalt ova t	RII
asfalt ov ý	RSI
atom	R
atom iz ova t	RSII
auto mat ick ý	RRII
auto mat iz ova t	RRSII
bab ičk a	RSI
babr a t	RII
baf a t	RII
bahn i t	RII
bahn išt ě	RSI
bahn o	RS
bal i t	RII
bal ík	RS
barv a	RI
barv en ý	RSI
barv i t	RII
bažin a	RI
bd í t	RII
bedn i t	RII
bedýn k a	RII
belh a t	RII
beton ova t	RII
bez po chyb y	RSRI
blaž e n ě	RISI
blaž i t	RII
blb nou t	RII
blesk nou t	RII
blik a t	RII
blik nou t	RII
bli nk a t	RSII
blok ova t	RII
bloud	R
bloud i t	RII
blouzn i l	RIS
blouzn i t	RII
blud iště	RR
blázen	R
blázn i t	RII
blázn iv ý	RSI
blázn ovstv í	RSI
blázín ek	RI
blí t	RI
blíž i t	RII
blýsk a t	RII
blýsk nou t	RII
bob ek	RI
bob eček	RS
bod	R
bod a t	RII
bod nou t	RII
bod ova t	RII
boh at nou t	RSII
boh at stv í	RSSI
boh at ý	RSI
boh at ě	RSI
boh yně	RS
boj	R
boj ova t	RII
bol e n í	RISI
bol est	RR
bol est n é	RRSI
bol e t	RII
bol n ý	RSI
bomb a	RI
bouch a t	RII
bouch nou t	RII
bouř i t	RII
box ova t	RII
boř i t	RII
bož sk ý	RII
bož stv o	RSS
bož stv í	RSI
bož í	RI
brambor	R
brambor a	RI
bratr	R
bratr anec	RS
bratř i t	RII
bratř íčk ova t	RSII
breč e t	RII
brn ě t	RII
brod iv ost	RSS
broj i t	RII
brouk a t	RII
brous i t	RII
brusl i t	RII
bruč e t	RII
brynd a t	RII
brzd i t	RII
brách a	RI
brách ův	RI
brán i t	RII
brázd i t	RII
buben	R
bubl a t	RII
bubn ova t	RII
bud i t	RII
bud ou c n ost	RSSSS
bud ova t	RII
buj e t	RII
buj n ý	RSI
buj n ě	RSI
buj n ě t	RSII
buš i t	RII
bydl e t	RII
by t	RI
by t ov ý	RISI
by t í	RII
bád a t	RII
bád á n í	RSSI
báseň	R
básn i t	RII
básn ík	RS
bíd a	RI
bíd n ý	RSI
bíd n ě	RSI
bíd ák	RS
bíl i t	RII
bíl ý	RI
bý t	RI
bý v a t	RSII
běh	R
běh a t	RII
běl a t	RII
běl e t	RII
běl i t	RII
běl och	RS
běs n i t	RSII
běž e t	RII
břiš n í	RSI
bříš k o	RIS
bůh	R
cap a t	RII
ced i t	RII
cement	R
cement ova t	RII
cen a	RI
cen i t	RII
cen n ý	RSI
centr al iz ova t	RSSII
centr ova t	RII
centr um	RR
cest a	RI
cest ičk a	RSI
cest ova t	RII
cest ova tel	RIS
cest uj íc í	RSSI
chab nou t	RII
chap a dl o	RISS
charakter iz ova t	RSII
chcíp a t	RII
chcíp nou t	RII
checht a t	RII
chlad nou t	RII
chlap	R
chlap ec	RI
chlap eč ek	RSI
chlap isk o	RSS
chlap ík	RS
chlast a t	RII
chlub i l	RIS
chlub i t	RII
chmel i t	RII
chod b a	PII
chod i dl o	PIPP
chod i t	PII
chod n ík	PPP
chov a n k a	RISII
chov a t	RII
chrapt ě t	RII
chrchl a t	RII
chrup a t	RII
chrup nou t	RII
chrán ěn ý	RSI
cht ě n í	RISI
cht ě n ý	RISI
chud nou t	RII
chud ák	RS
chud ý	RI
chur av ě t	RSII
chut n a t	RSII
chut n á n í	RSSSI
chuť	R
chvál en í	RSI
chvál i t	RII
chvát a t	RII
chvě t	RI
chyb i t	RII
chyb ova t	RII
chyb ě t	RII
chyst a t	RII
chyt a t	RII
chyt i t	RII
chyt nou t	RII
chytr ač i t	RSII
chytr ák	RS
chytr ý	RI
chytř e	RI
chýl i t	RII
chův a	RI
cibul e	RI
cink a t	RII
cit	R
cit eln ý	RSI
cit eln ě	RSI
civil izova n ý	RSSI
civil iz ova t	RSII
ciz inec	RS
cl o	RS
clon i t	RII
clon ov ě	RSI
cl í t	RII
cour a t	RII
couv a t	RII
cp á t	RSI
cuc a t	RII
cuch a t	RII
cuc nou t	RII
cuk a t	RII
cuker n at ě t	RSSII
cuk nou t	RII
cukr ova t	RII
cukr ová n í	RSSI
cukr átk o	RSS
cvak a t	RII
cvak nou t	RII
cvič en í	RSI
cvič i t	RII
cvál a t	RII
cykl us	RI
cák a t	RII
cák nou t	RII
cév k ova t	RIII
cíl	R
cíl i t	RII
cín ova t	RII
cít i t	RII
cít i teln ý	RISI
dab ova t	RII
dareb a	RI
daň ov ý	RSI
dař i t	RII
debat a	RI
debat ova t	RII
de centr al iz ova t	PRSSII
dech nou t	RII
de fin ova teln ý	PRISI
de fin ová n í	PRSSI
de form ova t	PRII
de gener ova t	PRII
dekor ac e	RSI
dekor ova t	RII
de mask ova t	PRII
de moral iz ova t	PRSII
de norm al iz ac e	PRSSSI
destil ova t	RII
destil át	RS
dez orient ova t	PRII
de šifr ova t	PRII
dikt ova t	RII
dimenz ova t	RII
diskut ova t	RII
div adlo	RR
div och	RS
div ok á	RIS
div oč i t	RRII
dlab a t	RII
dloub a t	RII
dloub nou t	RII
dluh	R
dluh ova t	RII
dluž i t	RII
dlážd i t	RII
dl í t	PII
dm ou t	RSI
do belh a t	PRII
do boj ova t	PRII
do bouř i t	PRII
dobr á	RS
dobr ák	RS
dobr ý	RI
do bud ova t	PRII
do buš i t	PRII
do by tí	PRR
do bíl i t	PRII
do bý t	PRI
do bý v a t	PRSII
do cen i t	PRII
do ceň ova t	PRII
do chod i t	PPII
do chov a t	PRII
do cház e t	PPII
do cil ova t	PRII
do cvál a t	PRII
do cíl i t	PRII
do drž e n í	PRISI
do drž e t	PRII
do drž ova t	PRII
do děl a t	PRII
do dř í t	PRII
do has nou t	PRII
do has ín a t	PRSII
do haz ova t	PRII
do hled a t	PRII
do hmát nou t	PRII
do hod i t	PRII
do hon i t	PRII
do hospod ař i t	PRSII
do hotov i t	PRII
do hovoř i t	PRII
do hrab a t	PRII
do hrá t	PRI
do hvízd a t	PRII
do hán ě t	PRII
do hřm í t	PRII
do hřm ě t	PRII
do hřá t	PRI
do jedn a t	PRII
do jedn á v a t	PRSSII
do jem	PR
do jím a t	PRII
do jís t	PRI
do jí t	PRI
do jížd ě t	PRII
do kaz ova t	PRII
do kaz ová n í	PRSSI
do klep a t	PRII
do klep á v a t	PRSSII
do klopýt a t	PRII
do kol a	PRI
do koléb a t	PRII
do kolíb a t	PRII
do kon a l e	PRISI
do kon a l ost	PRISS
do kon a t	PRII
do kon á v a t	PRSSII
do konč en í	PRSI
do konč i t	PRII
do konč ova t	PRII
do kop a t	PRII
do kos i t	PRII
do koup i t	PRII
do kral ova t	PRII
do kulh a t	PRII
dokument	R
dokument ova t	RII
do kup ova t	PRII
do kvas i t	PRII
do kvét a t	PRII
do káz a t	PRII
do křik nou t	PRII
do lad i t	PRII
do let ě t	PRII
do lož i t	PRII
do lét a t	PRII
do lé v a c í	PRSISI
do lé v a t	PRSII
do léz a t	PRII
do léz t	PRI
do léč i t	PRII
do lí t	PRI
do lít a t	PRII
do lí v a t	PRSII
do líz a t	PRII
do líč i t	PRII
dom a	RI
do mal ova t	PRII
do mlouv a t	PRII
do mluv en ý	PRSI
do mluv i t	PRII
do mlát i t	PRII
do ml í t	PRII
dom ov n ík	RSSS
do mysl e t	PRII
dom á c í	RSSI
do máh a t	PRII
do mý t	PRI
do mýšl e t	PRII
do měř i t	PRII
do nos i t	PRII
do nuc ova t	PRII
do nut i t	PRII
do náš e t	PRII
do nés t	PRI
do ob jedn a t	PPRII
do ob jedn á v a t	PPRSSII
do o sidl ova t	PPRII
do o sídl i t	PPRII
do pad a t	PRII
do pal ova t	PRII
do plav i t	PRII
do plaz i t	PRII
do pln ěn í	PRSI
do plét a t	PRII
do plíž i t	PRII
do plň ova t	PRII
do po moc i	PPRI
do po ruč en ý	PPRSI
do po ruč i t	PPRII
do po ruč ova t	PPRII
do poušt ě t	PRII
do po víd a t	PPRII
do po věd ě t	PPRII
do prac ova t	PRII
do prac ová v a t	PRSSII
do pr a t	PRII
do prav i t	PRII
do prav ova t	PRII
do proš ova t	PRII
do pr á n í	PRSSI
do pt a t	PRII
do pt á v a t	PRSSII
do pál en ě	PRSI
do pál i t	PRII
do pátr a t	PRII
do pátr á v a t	PRSSII
do péc i	PRI
do pék a t	PRII
do pík a t	PRII
do pín a t	PRII
do přá t	PRI
do přá v a t	PRSII
do raz i t	PRII
do roz um ě n í	PPRISI
do ruč en í	PRSI
do ruč i t	PRII
do ruč ova t	PRII
do rý t	PRI
do sah ova t	PRII
do sah uj íc í	PRSSI
do saž en í	PRSI
do sch nou t	PRII
do sek a t	PRII
do sidl ova t	PRII
do skoč i t	PRII
do skák a t	PRII
do slouž i t	PRII
do sluh ova t	PRII
do sn í t	PRII
do soud i t	PRII
do sp a t	PRII
do sp á v a t	PRSSII
do spí v aj íc í	PRSSSI
do spí v a t	PRSII
do spě t	PRI
do stač i t	PRII
do stač i teln ost	PRISS
do stih	PR
do stih nou t	PRII
do stih ova t	PRII
do stoup a n ý	PRISI
do strk a t	PRII
do stroj i t	PRII
do stroj ova t	PRII
do stud ova t	PRII
do stá t	PRI
do střel i t	PRII
do střík a t	PRII
do suš ova t	PRII
do syc ova t	PRII
do syp a t	PRII
do syp á v a t	PRSSII
do sídl i t	PRII
do sýp a t	PRII
do tah a t	PRII
do tah ova t	PRII
do taz ova t	PRII
do tik a t	PRII
do tisk nou t	PRII
do tk nou t	PRII
do tlač i t	PRII
do tlouk a t	PRII
do trh a t	PRII
do trp ě t	PRII
do tvoř i t	PRII
do tvrd i t	PRII
do tvrz ova t	PRII
do táh nou t	PRII
do táz a t	PRII
do téc i	PRI
do ték a t	PRII
do těsň ová n í	PRSSI
dou t	RI
do uč i t	PRII
do uč ova t	PRII
do vez en ý	PRSI
do vléc i	PRI
do vlék a t	PRII
do vol a t	PRII
do vol i t	PRII
do vol uj íc í	PRSSI
do vol á v a t	PRSSII
do voz	PR
do vrš i t	PRII
do vrš ova t	PRII
do vtíp i t	PRII
do véz t	PRI
do víd a t	PRII
do ví t	PRI
do věd ě t	PRII
do vř í t	PRII
do zn a t	PRII
do zn á v a t	PRSSII
do zn í t	PRII
do zn í v a t	PRISII
do zrá t	PRI
do zrá v a t	PRSII
do zvon i t	PRII
do z víd a t	PPRII
do z věd ě t	PPRII
do čerp a t	PRII
do čk a t	PRII
do řez a t	PRII
do říc i	PRI
do řík á v a t	PRSSII
do šláp nou t	PRII
do šour a t	PRII
do špin i t	PRII
do žad ova t	PRII
do žebr a t	PRII
do žebr á v a t	PRSSII
do žr a t	PRII
do žír a t	PRII
drah ouš ek	RSI
drah ý	RI
draž i t	RII
drb a n ý	RISI
drb a t	RII
drb nou t	RII
drk a t	RII
drk nou t	RII
drk ot a t	RSII
drnc a t	RII
drnc nou t	RII
drob et	RS
drob i t	RII
drob n ost	RSS
drob n ý	RSI
drol i t	RII
drt iv ý	RSI
druh	R
druž i t	RII
dráh a	RI
dráp a t	RII
dráp ek	RI
dráp nou t	RII
drás a t	RII
drát k ova t	RIII
drát ova t	RII
drážd i t	RII
dráž k ova t	RIII
drž e t	RII
duch	R
duch ař	RS
duch ovn í	RSI
duch ov n ě	RSSI
dum a t	RII
dup a t	RII
dup nou t	RII
dup á n í	RSSI
dus a t	RII
dus i t	RII
duš e	RI
duš ev n í	RRSI
duš ova t	RII
dvor ek	RI
dvor n í	RSI
dvoř i t	RII
dáv i t	RII
díl	R
díl ek	RI
díl em	RI
díl n a	RSI
dír k a	RII
dír k ova t	RIII
dí t	RI
dít ě	RI
dív a t	RII
dív enk a	RSI
dív k a	RII
dých a teln ý	RISI
dých nou t	RII
dým a t	RII
dým k a	RII
děc k o	RIS
děd eček	RS
děd ečk ův	RSI
děd i t	RII
dě j íc í	RRSI
děk ova t	RII
děl a t	RII
děl en ý	RSI
děl i t	RII
děl ník	RS
děl á n í	RSSI
děl á v a t	RSSII
dě n í	RSI
děr av ě t	RSII
děs	R
děs i t	RII
děs n ý	RSI
děs n ě	RSI
dět in št ě t	RSSII
dět sk ý	RII
děv a	RI
děv če	RS
děv č át k o	RSSIS
děť át k o	RSIS
dřev ař sk ý	RSII
dřev n at ě t	RSSII
dřev ě n ý	RISI
dřev ěn ě t	RSII
dřím a t	RII
dř í t	RII
dřív k o	RIS
důl ek	RI
dům	R
dů tk l iv ě	PRSSI
dů věř ova t	PRII
edit or sk ý	RSII
elektr ick ý	RII
elektř in a	RSI
energ et ik a	RSSI
energ et iz ova n ý	RSSISI
energ i e	RII
e nerv ova t	IRII
estet ik a	RSI
evrop sk ý	RII
exist enc e	RSI
exist enč n í	RSSI
exist ova t	RII
exist uj íc í	RSSI
experiment ova c í	RISI
experiment ova t	RII
ex port n í	RRSI
ex port ova t	RRII
faleš	R
faleš n ý	RSI
falš ova n ý	RISI
falš ová n í	RSSI
fax	R
fax ova c í	RISI
fax ov ý	RSI
faš izova n ý	RSSI
faš iz ova t	RSII
feder ova t	RII
fik nou t	RII
film	R
film ov ý	RSI
filtr ova t	RII
financ e	RI
financ ová n í	RSSI
finanč n ic tv í	RSSSI
finanč n í	RSI
finanč ník	RS
fint i t	RII
fix ova t	RII
flák a t	RII
flák nou t	RII
form a	RI
form ač n í	RSSI
form ová n í	RSSI
fouk a t	RII
fouk nou t	RII
frk a t	RII
frk nou t	RII
fráz ova t	RII
fréz ova t	RII
frč e t	RII
fung ova t	RII
fung ová n í	RSSI
fung uj íc í	RSSI
funkc e	RI
funkc ion ál n í	RRSSI
fár a t	RII
fáz e	RI
fňuk a t	RII
generál n í	RSI
german iz ova t	RSII
germán sk ý	RII
gum a	RI
had	R
hal i t	RII
han a	RI
han b a	RII
han b i t	RIII
handl ova t	RII
han ě t	RII
harmon ic k ý	RSII
harmon i e	RII
harmon iz ova t	RSII
harmon ova t	RII
has i č sk ý	RISII
has nou t	RII
hec ova t	RII
hek a t	RII
hlad c e	RSI
hlad i t	RII
hlad k ý	RII
hlad ov ý	RSI
hlad ov ě t	RSII
hlas	R
hlas it ě	RII
hlas ova t	RII
hlav a	RI
hlav eň	RI
hlav ičk a	RSI
hlav n í	RSI
hlav n ě	RSI
hled a n ý	RISI
hled a t	RII
hled isk o	RSS
hled á n í	RSSI
hled í	RI
hled ě t	RII
hlod a t	RII
hloub a t	RII
hloub i t	RII
hloup nou t	RII
hloup ý	RI
hlt a t	RII
hlub oc e	RRI
hlub ok o	RIS
hluch nou t	RII
hluch ý	RI
hluk	R
hlup ák	RS
hluč e t	RII
hlás a t	RII
hlás i t	RII
hlás k a	RII
hlás k ova t	RIII
hlíd a t	RII
hlíd k ova t	RIII
hlín a	RI
hmat a t	RII
hmát nou t	RII
hni l ob a	RSSI
hnus i t	RII
hn á t	RSI
hnízd i t	RII
hnízd o	RS
hněd nou t	RII
hněd ý	RI
hněv a t	RII
hobl ova t	RII
hod n ost n í	RSSSI
hod n ý	RSI
hod n ě	RSI
hol en ě	RSI
hol eň	RI
hol i t	RII
hol k a	RII
hol ot a	RSI
holoub ě	RI
holub	R
holub ič k a	RSII
hol č ičk a	RSSI
hon em	RI
hon i t	RII
hon i čk a	RIRI
hop k a t	RIII
hop k ova t	RIII
horl i t	RII
hor n í	RSI
hospod ař en í	RSSI
hospod ař i t	RSII
hospod yn ě	RSI
hospod ář sk ý	RSII
hospod ář ství	RSS
host	R
host inec	RS
host in sk y	RSII
host i t	RII
host ova t	RII
hotel	R
hotel nic tv í	RSSI
hotov i t	RII
hotov ý	RI
houb a	RI
houk a t	RII
houk nou t	RII
houp a t	RII
houp a čk a	RIRI
houst nou t	RII
hovor	R
hovoř i t	RII
hořk ost	RS
hrab a l	RIS
hrad b a	RII
hrad eb n í	RSSI
hrad ec	RI
hrad i t	RII
hrad išt ě	RSI
hran ič i t	RSII
hrb i t	RII
hrb áč ův	RSI
hrd in stv í	RSSI
hrk a t	RII
hrk ot a t	RSII
hr nou t	RII
hrnéč ek	RI
hrníč ek	RI
hrob ník ův	RSI
hrom	R
hromad a	RI
hromad i t	RII
hrom ova t	RII
hromád k a	RII
hrot i t	RII
hroz i t	RII
hroz n ý	RSI
hroz n ě	RSI
hrub ec	RI
hryz nou t	RII
hráb nou t	RII
hrá t	RI
hrá v á n í	RSSSI
hrá č	RS
hrůz a	RI
hub en ý	RSI
hub en ě t	RSII
hub i t	RII
hub ičk ova t	RSII
hub nou t	RII
hud b a	RII
hul i t	RII
hulák a t	RII
hust i t	RII
hust ý	RI
hutn ý	RI
hvízd a t	RII
hvízd nou t	RII
hvězd ičk a	RSI
hvězd ář	RS
hyzd i t	RII
hád a t	RII
hád á n í	RSSI
háj i t	RII
hák ova t	RII
ház e t	RII
háč ek	RI
háč k ova t	RIII
hýb a t	RII
hýb á n í	RSSI
hřeš i t	RII
hřm í t	RII
hřm ě t	RII
hřá t	RI
hřích	R
hřím a t	RII
hříš n ík	RSS
ideal iz ova t	RSII
ideal iz uj íc í	RSSSI
ideál	R
ideál n í	RSI
ilustr ov an ý	RSSI
index	R
in filtr ova t	PRII
in form ac e	PRSI
in form ač n í	PRSSI
inov ace	RS
in scen ova t	PRII
in stal ac e	PRSI
instrument ova t	RII
integr ova t	RII
intelekt	R
intelekt uál n í	RSSI
intelekt u ál n ě	RSSSI
intelekt uál sk ý	RSII
intrik ova t	RII
izol ov an ost	RSSS
izol ova t	RII
jadr n ý	RSI
jan k ova t	RIII
jan k ov sk ý	RISII
jan č i t	RSII
jas n o	RSS
jas n ý	RSI
jas n ě	RSI
jedn a t	RII
jedn a tel	RIS
jedn ot i t	RSII
jedn ot liv ec	RSSI
jedn ot liv ost	RSSS
jedn ot liv ý	RSSI
jedn á n í	RSSI
jehl a	RI
je t	RI
jev	R
jev i t	RII
jev išt ě	RSI
jezd i t	RII
ječ e t	RII
jež at ý	RSI
jež i t	RII
jiskr a	RI
jiskr n ý	RSI
jiskř i t	RII
jist ot a	RSI
jist ý	RI
jist ě	RI
jmen ova t	RII
jmen ovit ě	RSI
jmén o	RS
jás a t	RII
jím a t	RII
jís t	RI
jí t	RI
jízd a	RI
jízd n í	RSI
jód ova t	RII
kadeř i t	RII
kal i t	RII
kamarád	R
kamarád i t	RII
kamen ova t	RII
kamen í	RI
kamen ě t	RII
kanal iz ova t	RSII
kanál	R
kap al n i t	RSSII
kap al n ě t	RSSII
kapitál n í	RSI
kap ičk a	RSI
kap ičk ov ě	RSSI
kap k a	RII
kaps ičk a	RSI
kaps ář	RS
kart a	RI
kart ova t	RII
kartáč ek	RI
kartáč ova t	RII
kašel	R
kašl a t	RII
kec a t	RII
klad iv ář	RSS
klam a t	RII
klam á n í	RSSI
klap a t	RII
klap nou t	RII
klasic k ý	RII
klek a t	RII
klek nou t	RII
klep a t	RII
klep n a	RSI
klep nou t	RII
kles nou t	RII
klest i t	RII
kleč e t	RII
klešt i t	RII
klid	R
klid i t	RII
klid n ý	RSI
klih ova t	RII
klik at i t	RSII
klim a	RI
klim atick ý	RRI
klon i t	RII
klop i t	RII
klopýt a t	RII
klopýt av ě	RSI
kloub i t	RII
klouz a t	RII
klov a t	RII
klov nou t	RII
klub a t	RII
klus a t	RII
klábos i t	RII
klás t	RI
klát i t	RII
klín	R
klín ova t	RII
klí t	RI
klíč	R
klíč i t	RII
klíž i t	RII
kmit a t	RII
kmit nou t	RII
knih ova t	RII
knih ovn a	RSI
kníž e	RI
kníž k a	RII
koc ouř í	RSI
kodrc a t	RII
koj en ec	RSI
koj i t	RII
koj n á	RSS
kokt a l	RIS
kokt a t	RII
ko labor ova t	PRII
koled ova t	RII
kol em	RI
kol k ova t	RIII
kol o	RS
kolon iz ova t	RSII
kol ova t	RII
koléb a t	RII
kolíb a t	RII
kol ík ova t	RSII
kombin ac e	RSI
kombin ova n ý	RISI
koment ova t	RII
koment át or	RSS
komor a	RI
komor n ík	RSS
kompil ova t	RII
kom pon ova t	RRII
kompost ova t	RII
komun ik ac e	RSSI
kon a t	RII
konc ov ě	RSI
kondenz átor	RS
konec	R
konejš i t	RII
koneč ek	RI
koneč n ík	RSS
koneč n ě	RSI
kon feder ova t	RRII
kon sign ova t	RRII
kon struk c e	RRSI
kontrol a	RI
kontrol ova t	RII
konzult ac e	RSI
konzult ova t	RII
kon íčk ova t	RSII
ko oper ac e	PRSI
ko oper ova t	PRII
ko ordin ova t	PRII
kop a nec	RIS
kop nou t	RII
kor a t	RII
ko rmout i t	PRII
kor n at ě t	RSSII
kos i t	RII
kost	R
kost ičk a	RSI
kost n at ě t	RSSII
kost ra	RI
kotv a	RI
kotv i t	RII
kot ě	RI
kouk a t	RII
koul e	RI
koul e t	RII
koul ova t	RII
koup el	RR
koup i t	RII
koup á n í	RSSI
koup ě	RI
kous a t	RII
kous nou t	RII
kouzel n ic e	RSSI
kouzel n ík	RSS
kouzl i t	RII
kouzl o	RS
kouř i t	RII
koč ič í	RSI
koč k ova t	RIII
koč ova t	RII
koč í	RI
kořen i t	RII
kořist	R
kořist i t	RII
kož en ý	RSI
kraj an	RS
kraj n ost	RSS
kraj án ek	RSI
kral ova t	RII
kral ová n í	RSSI
kram ař i t	RSII
kras av ic e	RSSI
krev	R
krev n í	RSI
krk a t	RII
krk nou t	RII
krm i t	RII
krok	R
krok em	RI
krop i t	RII
krot i t	RII
krot nou t	RII
krouh a t	RII
krout i t	RII
krouž ek	RI
krouž k ova t	RIII
kruh	R
kruš i t	RII
krv av ý	RSI
krv ác e t	RSII
krystal ova t	RII
kry t í	RII
krád ež	RS
kráj e t	RII
král k a	RII
král ov n a	RSSI
král ov sk ý	RSII
král ov stv í	RSSI
král ův	RI
krám ek	RI
krám y	RI
krás a	RI
krás n ě	RSI
krás n ě t	RSII
krás t	RI
krát c e	RSI
krát i t	RII
krát k ý	RII
kráč e t	RII
kráš l ic í	RSSI
kráš l i t	RSII
krý t	RI
krč i t	RII
kuch a t	RII
kuk a t	RII
kul at ě t	RSII
kulh a t	RII
kulh a v ý	RISI
kul i t	RII
kult iv ova t	RSII
kult ur a	RSI
kult ur n ost	RSSS
kult ur n í	RSSI
kup a	RI
kup i t	RII
kup k ova t	RIII
kup ova t	RII
kut a t	RII
kut i t	RII
kutál e t	RII
kuř ác k ý	RSII
kvap i t	RII
kvas i t	RII
kvet ou c í	RSSI
kyd a t	RII
kyp ě t	RII
kys a t	RII
kys el i t	RRII
kys nou t	RII
kác e t	RII
kál e t	RII
kámen	R
kár a t	RII
ká t	RI
káz a t	RII
kód	R
kýv a t	RII
kýv nu t í	RSII
křeh k ý	RII
křeh nou t	RII
křes a t	RII
křes nou t	RII
křesť an sk y	RSII
křik	R
křik nou t	RII
křiv i t	RII
křiv k a	RII
křič e t	RII
křiž ova t	RII
křup a t	RII
křup nou t	RII
křáp a t	RII
křáp nou t	RII
křís nou t	RII
kříž	R
kříž ek	RI
kříž i t	RII
kříž k ova t	RIII
kříž ovník ův	RSI
kříž ov ý	RSI
kůl n ičk a	RSSI
kůň	R
kůž e	RI
kůž ičk a	RSI
labor ova t	RII
lad i t	RII
lad ěn í	RSI
lahod i t	RII
lak ýr ová n í	RSSSI
lan ař i t	RSII
lap a t	RII
lap i t	RII
lap nou t	RII
lask a t	RII
lask av ý	RSI
lask a v ě	RISI
latin sk y	RII
lecht a t	RII
led	R
led ova t	RII
led ov ec	RSI
led ov ý	RSI
led ov ě	RSI
legitim n í	RSI
legitim ova n ý	RISI
legitim ova t	RII
legál ní	RS
lek a t	RII
lek nou t	RII
lem ova t	RII
len i t	RII
len och	RS
len ost	RS
lept a t	RII
lesk l ý	RSI
lesk nou t	RII
les n í	RSI
let	R
let a dl o	RISS
let ec k ý	RIII
let it ý	RII
let n í	RSI
let os	RS
let áč ek	RSI
lev ý	RI
lešt i t	RII
lež	R
liberal iz ac e	RSSI
lichot i t	RII
lid ov ý	RSI
lid sk y	RII
likvid ac e	RSI
likvid ova t	RII
limit ova t	RII
lini e	RI
lis ova t	RII
list	R
list ova t	RII
lit ova t	RII
liš en í	RSI
lod ičk a	RSI
lok al iz ova t	RSSII
lok ální	RS
lom i t	RII
los	R
los ova t	RII
loud a t	RII
loud i t	RII
louh ova t	RII
loup a t	RII
loup ež i t	RSII
loup ež n ic tv í	RSSSSI
loup ež n ík	RSSS
loup i t	RII
loup nou t	RII
lousk a t	RII
lousk nou t	RII
loutk ař	RS
louč i t	RII
louž i t	RII
lov ec	RI
lov ec k ý	RIII
lov i t	RII
loď	R
lož i t	RII
lup i č	RIS
lušt i t	RII
lyž ař i t	RSII
lyž ova t	RII
lák a t	RII
lám a t	RII
lát a t	RII
lék	R
lék ař	RS
lét a t	RII
lét o	RS
léz t	RI
léč b a	RII
léč i t	RII
líb nou t	RII
lím ec	RI
lín a t	RII
lí t	RI
lít a t	RII
líz a l	RIS
líz a t	RII
líč i t	RII
mach	R
magnet iz ova t	RSII
magnet ova t	RII
mal in k ý	RSII
mal ičk o	RSS
mal ičk ost	RSS
mal íř	RS
mal íř stv í	RSSI
manévr ova t	RII
map ova t	RII
mar n ě	RSI
marod i t	RII
mask a	RI
mask ova t	RII
mast i t	RII
mas áž	RS
mas ér	RS
mas ír ova t	RSII
mater i ál	RIS
matl a t	RII
mat ou c í	RSSI
maz a t	RII
maz a v k a	RISII
mazl i t	RII
maďar sk ý	RII
mař i t	RII
mašt ěn í	RSI
mdl í t	RII
mechan ist ick ý	RRII
mechan iz ova t	RSII
medit ač n í	RSSI
med ova t	RII
medvíd ek	RI
medvíd ě	RI
medvěd	R
mejl k a	RII
mek ot a t	RSII
mel a	RI
meč e t	RII
mešk a t	RII
mhouř i t	RII
mil e	RI
mil en ec	RSI
mil k ova t	RIII
mil ost iv ý	RSSI
mil ost n ý	RSSI
mil ova t	RII
mil ová n í	RSSI
mil áček	RS
mil ý	RI
minerál n í	RSI
ministr	R
ministr ův	RI
mix ova t	RII
miz e t	RII
miz in a	RSI
mlad i t	RII
mlad ík	RS
mlad ý	RI
mlad ě	RI
mlask nou t	RII
mls a t	RII
mluv i t	RII
mlád nou t	RII
mlád í	RI
mlád ě	RI
mlát i t	RII
mláz í	RI
mlék o	RS
mléč n ý	RSI
mlík o	RS
ml í t	RII
mlíč k o	RIS
ml ýn	RS
mlč e n í	RISI
mlč e t	RII
mlž i t	RII
mnoh d y	RRI
mnoh o	RS
mnoh ost	RS
mnoh ý	RI
množ i t	RII
moc	R
moc i	RI
moc n i t	RSII
moc n ost	RSS
moc n ý	RSI
moc n ě	RSI
model	R
model ova n ost	RISS
moder ova t	RII
modr ý	RI
modř i t	RII
mok nou t	RII
mok r o	RIS
mont ova t	RII
mont ér	RS
moral iz ova t	RSII
mord ova t	RII
mord ýř	RS
morál n í	RSI
most	R
mot a t	RII
motiv ac e	RSI
motiv ov an ý	RSSI
motiv ova t	RII
motor	R
motor ov ý	RSI
moudr ost	RS
moudr ý	RI
moudř e	RI
moč i t	RII
moř e	RI
moř i t	RII
mrav n í	RSI
mraz i t	RII
mrač i t	RII
mrh a t	RII
mrk a t	RII
mrsk a t	RII
mrsk nou t	RII
mrtv ol n ý	RSSI
mrtv ý	RI
mrz ač i t	RSII
mrz nou t	RII
mrz ut ě	RII
mráz	R
mršt i t	RII
mst i v ě	RISI
mst í t	RII
muchl a t	RII
muchl ova t	RII
muk a	RI
mut ova t	RII
muzik a	RI
muč írn a	RSI
muž	R
muž n ý	RSI
muž n ě t	RSII
muž sk ý	RII
muž stv í	RSI
myk a t	RII
myk nou t	RII
mysl	R
mysl e t	RII
mysl i t	RII
mysl i tel stv í	RISSI
my t í	RII
myšl e n k a	RISII
myšl en k ov ý	RSISI
myšl e n í	RISI
mách a t	RII
mák nou t	RII
mál o	RS
mám i t	RII
máv aj íc í	RSSI
máv a t	RII
máv nou t	RII
máz nou t	RII
máč e t	RII
mích a t	RII
míj e t	RII
mín ěn í	RSI
míst ečk o	RSS
míst o	RS
míř i t	RII
mód a	RI
mýl i t	RII
mý t	RI
mýt in a	RSI
mýt i t	RII
měk c e	RSI
měk nou t	RII
měn a	RI
měn i t	RII
měn ový	RS
měst ečk o	RSS
měst o	RS
měst sk ý	RII
mř í t	RII
mříž	R
mříž k ova t	RIII
na bal i t	PRII
na barv i t	PRII
na blýsk á n í	PRSSI
na bod nou t	PRII
na bouch a t	PRII
na bour a t	PRII
na bíl i t	PRII
na bý t	PRI
na běh a t	PRII
na chlad i t	PRII
na chlad nou t	PRII
na chlast a t	PRII
na chmel i t	PRII
na chod i t	PPII
na chyst a t	PRII
na chyt a t	PRII
na cház e t	PPII
na chýl i t	PRII
nac ism us	RRI
nac ist ick ý	RRII
na cp a t	PRII
na cp á v a t	PRSSII
na cuc a t	PRII
na cvič i t	PRII
na cvič ova t	PRII
na cák a t	PRII
na cák nou t	PRII
nad cen i t	PRII
na dch nou t	PRII
na dech nou t	PRII
na dech ova t	PRII
nade je t	PRI
nade zd í t	PRII
nade zd í v a t	PRISII
nad haz ova t	PRII
nad hled	PR
nad hod i t	PRII
na dikt ova t	PRII
nad je t	PRI
nad jížd ě t	PRII
na dm ou t	PRSI
nad náš e t	PRII
nad nés t	PRI
na doj i t	PRII
na dou t	PRI
nad po ruč ík ov á	PPRSSS
nad pro duk c e	PPRSI
na drob en ý	PRSI
na drob i t	PRII
na dráp a t	PRII
na drát ova n ě	PRISI
na drž e t	PRII
na drž ova t	PRII
nad skak ova t	PRII
nad skoč i t	PRII
na duř e t	PRII
na dych ova t	PRII
nad zdvih nou t	PRII
nad z ved nou t	PPRII
na díl e t	PRII
na dí v a t	PRSII
na dých a t	PRII
na dých nou t	PRII
na děl a t	PRII
na děl i t	PRII
na děl ova t	PRII
na děr ova t	PRII
nad řad i t	PRII
nad řaz ova t	PRII
na fint i t	PRII
na flák a t	PRII
na fouk a t	PRII
na fuk ova t	PRII
na gum ova t	PRII
na hled a t	PRII
na hlod a t	PRII
na hlt a t	PRII
na hlás it	PRI
na hlíd a t	PRII
na hmat a t	PRII
na hmát nou t	PRII
na hní t	PRI
na hní v a t	PRSII
na hněv a t	PRII
na hon i t	PRII
na hospod ař i t	PRSII
na hrab a t	PRII
na hrab ova t	PRII
na hrad i t	PRII
na hrad i teln ost	PRISS
na hr nou t	PRII
na hromad i t	PRII
na hryz a t	PRII
na hryz nou t	PRII
na hrá t	PRI
na hrá v a t	PRSII
na hust i t	PRII
na ház e t	PRII
nah áč	RS
nah ý	RI
na hřá t	PRI
na in stal ova t	PPRII
na je t	PRI
na jezd i t	PRII
na jež i t	PRII
na jmen ova t	PRII
na jím a t	PRII
na jí t	PRI
na jížd ě t	PRII
na kadeř i t	PRII
na kap a t	PRII
na kaz i t	PRII
na kec a t	PRII
na klad a tel stv í	PRISSI
na klep a t	PRII
na klep á v a t	PRSSII
na klon ěn ý	PRSI
na kloň ova t	PRII
na klábos i t	PRII
na klád a t	PRII
na klád á n í	PRSSI
na klán ě t	PRII
na klíč i t	PRII
na klíž i t	PRII
na komand ova t	PRII
na konec	PR
na kop a t	PRII
na kop nou t	PRII
na kop á v a t	PRSSII
na kouk a t	PRII
na kouk nou t	PRII
na koup i t	PRII
na kous nou t	PRII
na kouř i t	PRII
na kořist i t	PRII
na krm i t	PRII
na krop i t	PRII
na kruc ova t	PRII
na kráj e t	PRII
na krč i t	PRII
na kuk a t	PRII
na kuk ova t	PRII
na kup i t	PRII
na kup ova t	PRII
na kvas i t	PRII
na kvaš ova t	PRII
na kyd a t	PRII
na kyp ě t	PRII
na kys a t	PRII
na kys l e	PRSI
na kys nou t	PRII
na kác e t	PRII
na káz a t	PRII
na křiv i t	PRII
na křiv ova t	PRII
na křáp nou t	PRII
na lad i t	PRII
na lak ova n ý	PRISI
na lak ova t	PRII
na lap a t	PRII
na len oš i t	PRSII
na lept a t	PRII
na let ova t	PRII
na let ě t	PRII
na lev o	PRS
na lešt i t	PRII
na lh a t	PRII
na lh á v a t	PRSSII
na lom i t	PRII
na loup a t	PRII
na loup nou t	PRII
na lov i t	PRII
na lož i t	PRII
na lám a t	PRII
na lé v a t	PRSII
na léz a t	PRII
na lí t	PRI
na lít a t	PRII
na lí v a t	PRSII
na líz nou t	PRII
na líč i t	PRII
na mak a t	PRII
na mal ova t	PRII
na mask ova t	PRII
na mast i t	PRII
na mas ír ova t	PRSII
na maz a t	PRII
na mačk a t	PRII
na mlouv a t	PRII
na mls a t	PRII
na mluv i t	PRII
na mlát i t	PRII
na ml í t	PRII
na mnoz e	PRI
na moc i	PRI
na modř i t	PRII
na mont ova t	PRII
na mot a t	PRII
na mot á v a t	PRSSII
na moř i t	PRII
na mrsk a t	PRII
na mysl e t	PRII
na mysl i t	PRII
na máh a t	PRII
na mák nou t	PRII
na máz nou t	PRII
na máč e t	PRII
na míř i t	PRII
na měk nou t	PRII
na měř i t	PRII
na nos i t	PRII
na náš e t	PRII
na nés t	PRI
na ob těž ova t	PPRII
na olej ova t	PRII
na ostř i t	PRII
na pad a t	PRII
na pad nou t	PRII
na pad á v a t	PRSSII
na parfém ova t	PRII
na par ova t	PRII
na parád i t	PRII
na pař i t	PRII
na pař ova t	PRII
na pich ova t	PRII
na pil ova t	PRII
na pj a t ý	PRIII
na plak a t	PRII
na plat i t	PRII
na plav ova t	PRII
na plesk a t	PRII
na pliv nou t	PRII
na pln i t	PRII
na plác a t	PRII
na plán ova t	PRII
na plét a t	PRII
na plí t	PRI
na po hlav k ova t	PPRIII
na po moc i	PPRI
na po rouč e t	PPRII
na po smí v a t	PPRSII
na po síl a t	PPRII
na poušt ě t	PRII
na po víd a t	PPRII
na po věd ě t	PPRII
na prac ová v a t	PRSSII
na prav i t	PRII
na prav ova t	PRII
na pros i t	PRII
na prásk a t	PRII
na práš i t	PRII
na prš e t	PRII
na ps a t	PRII
na puk nou t	PRII
na pump ova t	PRII
na pust i t	PRII
na put ova t	PRII
na pách a t	PRII
na pál i t	PRII
na pás t	PRI
na péc i	PRI
na pích a t	PRII
na pín a t	PRII
na písk a t	PRII
na pěch ova t	PRII
na pěn i t	PRII
na přim ova t	PRII
na přím i t	PRII
na raz i t	PRII
na rob i t	PRII
na rod i t	PRII
na roub ova t	PRII
na roz en ý	PPPI
na ruš i t	PRII
na ruš ova t	PRII
na rv a t	PRII
na ráž e t	PRII
na rýp a t	PRII
na rýs ova t	PRII
na sak ova t	PRII
na sed ě t	PRII
na sek a t	PRII
na sek nou t	PRII
na s hromážd i t	PPRII
na s hán ě t	PPRII
na skak ova t	PRII
na s klád a t	PPRII
na skoč i t	PRII
na skák a t	PRII
na slin i t	PRII
na slouch a t	PRII
na slouž i t	PRII
na sluh ova t	PRII
na smá t	PRI
na s níd a t	PPRII
na sol i t	PRII
na souk a t	PRII
na souk á v a t	PRSSII
na spoř i t	PRII
na star a t	PRII
na start ova t	PRII
na sta t	PRI
na steh ova t	PRII
na stiň ova t	PRII
na stoup i t	PRII
na strach ova t	PRII
na straš i t	PRII
na strk a t	PRII
na strk ova t	PRII
na strk á v a t	PRSSII
na stroj i t	PRII
na stroj ova t	PRII
na strouh a t	PRII
na strč i t	PRII
na stud i t	PRII
na stud ova t	PRII
na stup ova t	PRII
na styd nou t	PRII
na stá t	PRI
na stín i t	PRII
na stěh ová v a t	PRSSII
na střik ova t	PRII
na střád a t	PRII
na střík a t	PRII
na střík nou t	PRII
na střík á v a t	PRSSII
na stříl e t	PRII
na svač i t	PRII
na svíc en í	PRSI
na syc ova t	PRII
na syp a t	PRII
na syp á v a t	PRSSII
na sá t	PRI
na sá v a t	PRSII
na tah uj íc í	PRSSI
na tanc ova t	PRII
na tisk nou t	PRII
na tlach a t	PRII
na tlač i t	PRII
na tlouc i	PRI
na tlouk a t	PRII
na toul a t	PRII
na touž i t	PRII
na toč i t	PRII
na tref i t	PRII
na trh a t	PRII
na trh nou t	PRII
na trh á v a t	PRSSII
na troub i t	PRII
na trous i t	PRII
na táč e t	PRII
na téc i	PRI
na ték a t	PRII
na tír a t	PRII
na týr a t	PRII
na těsn a t	PRII
na těš i t	PRII
na třep a t	PRII
na třás a t	PRII
na třás t	PRI
na třísk nou t	PRII
na tř í t	PRII
na uč en í	PRSI
na uč i t	PRII
na val ova t	PRII
na vaz ova t	PRII
na vař i t	PRII
na verb ova t	PRII
na večeř e t	PRII
na vlas	PR
na vlaž i t	PRII
na vlaž ova t	PRII
na vlh nou t	PRII
na vlh č i t	PRSII
na vlh č ova t	PRSII
na vléc i	PRI
na vlék a t	PRII
na vlík a t	PRII
na vol a t	PRII
na von ě t	PRII
na vosk ova t	PRII
na voz i t	PRII
na vrac e t	PRII
na vrh ova t	PRII
na vrstv i t	PRII
na vrt a t	PRII
na vrt ě t	PRII
na vrát i t	PRII
na vy mýšl e t	PPRII
na vy pt á v a t	PPRSSII
na vál e t	PRII
na vá t	PRI
na váz a t	PRII
na váz á n í	PRSSI
na váž e t	PRII
na ví t	PRI
na věs i t	PRII
na věš e t	PRII
navštív en ý	RSI
navštív i t	RII
navštěv ova t	RII
na zdvih nou t	PRII
na zdvih ova t	PRII
naz e	RI
na zelen i t	PRII
na zl ob i t	PRSII
na znak	PR
na znač i t	PRII
na znač ova t	PRII
na zou t	PRI
na zv a t	PRII
na čad i t	PRII
na čap a t	PRII
na ček a t	PRII
na čep ova t	PRII
na čepýř i t	PRII
na čern i t	PRII
na čerp a t	PRII
na čerp á v a t	PRSSII
na červen i t	PRII
na čerň ova t	PRII
na čes a t	PRII
na čes á v a t	PRSSII
na čich á v a t	PRSSII
na čmár a t	PRII
na čoud i t	PRII
na čp ě t	PRII
na čuch a t	PRII
na čuch nou t	PRII
na řas ova t	PRII
na řez a t	PRII
na řez á v a t	PRSSII
na řiz ova t	PRII
na řk nou t	PRII
na řv a t	PRII
na říd i t	PRII
na říz k ová n í	PRISSI
na říz nou t	PRII
na šept a t	PRII
na šetř i t	PRII
na škrob i t	PRII
na šlap a t	PRII
na šlap ova t	PRII
na šlap á v a t	PRSSII
na šleh a t	PRII
na špendl i t	PRII
na špik ova t	PRII
na špin i t	PRII
na šroub ova t	PRII
na štv a t	PRII
na štíp a t	PRII
na štíp nou t	PRII
na štěp ova t	PRII
na štěst í	PRI
na švih a t	PRII
na švih nou t	PRII
na ší t	PRI
na ší v a t	PRSII
na šťouch a t	PRII
na šťouch nou t	PRII
na ťap a t	PRII
na ťuk nou t	PRII
na žr a t	PRII
na žvatl a t	PRII
na ží t	PRI
ne blah ý	PRI
nech a t	RII
ne chuť	PR
nech á v a t	RSSII
ne děl e	PRI
ne mluv n ý	PRSI
ne mluv n ě	PRSI
ne mluv ň át k o	PRSSIS
ne moc	PR
ne moc nic e	PRSI
ne na syt n ý	PPRSI
ne ná vid ě t	PPRII
ne patr n ý	PRSI
ne po chyb n ě	PPRSI
ne ruš en ý	PRSI
neuróz a	RI
ne vol n o	PRSS
ne víd a n ý	PRISI
ne řád	PR
nič i t	RII
noh a	RI
noh av ic e	RSSI
nomin ova t	RII
norm a	RI
norm al iz ač n í	RSSSSI
norm al iz ova n ý	RSSISI
norm al iz ova t	RSSII
norm ova t	RII
norm ál n í	RSSI
nos	R
nos i t	RII
not ova t	RII
novel iz ova t	RSII
nov in y	RSI
nov in ář	RSS
nov ý	RI
nov ě	RI
noč n í	RSI
nud i t	RII
nut i t	RII
nut k a t	RIII
nut n ý	RSI
nut n ě	RSI
nuz ova t	RII
ná bož en sk ý	PRSII
ná bož en stv í	PRSSI
ná draž n í	PRSI
ná draž í	PRI
ná jem n é	PRSI
ná jem n í	PRSI
ná kup	PR
ná kup n í	PRSI
ná lad a	PRI
ná moř n ík	PRSS
ná měst í	PRI
ná pad n ý	PRSI
ná pad n ě	PRSI
ná prs n í	PRSI
ná rod n í	PRSI
ná rok	PR
ná roč n ý	PRSI
ná sil í	PRI
ná sled ek	PRI
ná sled ov an ý	PRSSI
ná sled ova t	PRII
ná sled ov ník	PRSS
ná stup	PR
ná vrat	PR
ná vrh	PR
nés t	RI
níz k o	RIS
níz ký	RI
nýt ova t	RII
o bahn i t	PRII
o bal i t	PRII
o bal ova t	PRII
o barv i t	PRII
o barv ova n ý	PRISI
ob cház e t	PPII
ob dař i t	PRII
ob dař ova t	PRII
ob děl a t	PRII
ob děl á v a t	PRSSII
o bedn i t	PRII
obe hrá t	PRI
obe hrá v a t	PRSII
obe pín a t	PRII
obe zd í t	PRII
obe zd í v a t	PRISII
ob haj ob a	PRSI
ob haj ova t	PRII
ob hospod ař i t	PRSII
ob hospod ař ova t	PRSII
ob háj i t	PRII
ob háč k ova t	PRIII
ob jedn á v a t	PRSSII
ob jev	PR
ob jev i t	PRII
ob jezd i t	PRII
ob jížd ě t	PRII
ob klič ova t	PRII
ob klop i t	PRII
ob klop ova t	PRII
ob klíč i t	PRII
ob krouž i t	PRII
o blaž i t	PRII
o blb ova t	PRII
ob lek	PR
ob leč en ý	PRSI
ob liz ova t	PRII
ob loh a	PRI
ob lom i t	PRII
ob loud i t	PRII
ob lož i t	PRII
ob léc i	PRI
ob lék an ý	PRSI
ob lék nou t	PRII
ob lék á n í	PRSSI
ob lé v a t	PRSII
ob léz a t	PRII
ob léz t	PRI
ob lí t	PRI
ob lí v a t	PRSII
ob líz a t	PRII
ob líz nou t	PRII
ob mysl i t	PRII
ob mý t	PRI
ob měk č i t	PRSII
ob měn a	PRI
ob měn i t	PRII
ob měň ova t	PRII
ob naž ova t	PRII
ob nos i t	PRII
ob nov a	PRI
ob nov en í	PRSI
ob nov ova t	PRII
o bol av ě t	PRSII
o boř i t	PRII
o boř ova t	PRII
ob rac e t	PRII
ob rat el	PRR
ob raz	PR
ob raz ec	PRI
ob raz i t	PRII
ob raz ov k a	PRSII
ob raz ov ý	PRSI
o brn i t	PRII
ob rod i t	PRII
ob rod i tel sk ý	PRISII
ob roz ova t	PPII
ob rác e n ě	PRISI
o brán i t	PRII
ob rát i t	PRII
ob ráz ek	PRI
ob rý t	PRI
ob růst a t	PRII
ob sah ova t	PRII
ob sek a t	PRII
ob sek á v a t	PRSSII
ob skak ova t	PRII
ob slouž i t	PRII
ob sluh ova t	PRII
ob star a t	PRII
ob stá t	PRI
ob syp a t	PRII
ob syp á v a t	PRSSII
ob sáh l ý	PRSI
ob sáh nou t	PRII
ob tah ova t	PRII
ob tanč i t	PRII
ob tisk nou t	PRII
ob tisk ova t	PRII
ob toč i t	PRII
ob táh nou t	PRII
ob táč e t	PRII
ob téc i	PRI
ob ték a t	PRII
ob tíž	PR
ob tíž i t	PRII
ob těž k a t	PRIII
ob těž k á v a t	PRISSII
ob těž ova t	PRII
ob vesel ova t	PRII
ob vin i t	PRII
ob viň ova t	PRII
ob váz a t	PRII
o by v a tel	PRSIS
o bál k a	PRII
o bíh a t	PRII
o bíl i t	PRII
o bý v a t	PRSII
obč an	RS
ob čas n ý	PRSI
o běh a t	PRII
o běh nou t	PRII
o běh ov ý	PRSI
obět ová n í	RSSI
oběť	R
o běž n ý	PRSI
ob řez a t	PRII
ob říz nou t	PRII
ob ší t	PRI
ob ší v a t	PRSII
ob žal ova t	PRII
ocel	R
ocel ov ý	RSI
o cen i t	PRII
o ceň ova t	PRII
o chab nou t	PRII
o chab nu t í	PRSII
o chab ova t	PRII
o chlad i t	PRII
o chlad nou t	PRII
o chlaz ení	PRS
o chlaz ova t	PRII
o chmel i t	PRII
o choř e t	PRII
o chran a	PRI
o chran i tel sk y	PRISII
o chrapt ě l ý	PRISI
o chrapt ě t	PRII
o chraň ova t	PRII
o chud i t	PRII
o chut n a t	PRSII
o chuz ova t	PRII
o cit ova t	PRII
o cuc á v a t	PRSSII
o cukr ova t	PRII
od barv i t	PRII
od bav i t	PRII
od bav ova t	PRII
od belh a t	PRII
od belh á v a t	PRSSII
od bour a t	PRII
od boč i t	PRII
od brzd i t	PRII
od bý t	PRI
od bý v a t	PRSII
od cest ova t	PRII
od chov a t	PRII
od chov á v a t	PRSSII
od chrchl a t	PRII
od chvát a t	PRII
od chyl ova t	PRII
od cház e t	PPII
od chýl i t	PRII
od ciz i t	PRII
od clon i t	PRII
od cloň ova t	PRII
od cvál a t	PRII
od dech nou t	PRII
od dech ova t	PRII
od diskut ova t	PRII
od drob i t	PRII
od drob ova t	PRII
od drol i t	PRII
od drol ova t	PRII
od dych nou t	PRII
od dych ova t	PRII
od děl a t	PRII
od děl en í	PRSI
od děl i t	PRII
od děl ova t	PRII
od děl á v a t	PRSSII
od dř í t	PRII
ode dř í t	PRII
ode hrá t	PRI
ode hrá v a t	PRSII
ode je t	PRI
ode jí t	PRI
ode pis ova t	PRII
ode ps a t	PRII
ode pín a t	PRII
ode pír a t	PRII
ode př í t	PRII
ode rv a t	PRII
od flák a t	PRII
od fouk a t	PRII
od fouk nou t	PRII
od fouk á v a t	PRSSII
od frk nou t	PRII
od frk ova t	PRII
od frč e t	PRII
od fuk ova t	PRII
od hal en í	PRSI
od hal i t	PRII
od hal ova n ý	PRISI
od hal ova t	PRII
od haz ova t	PRII
od hlas ova t	PRII
od hlaš ova t	PRII
od hlás i t	PRII
od hod i t	PRII
od houk a t	PRII
od hrab a t	PRII
od hrab á v a t	PRSSII
od hrk a t	PRII
od hr nou t	PRII
od ház e t	PRII
od jist i t	PRII
od jišť ova t	PRII
od kap a t	PRII
od kap ova t	PRII
od kaz ova t	PRII
od kašl a t	PRII
od kašl á v a t	PRSSII
od klid i t	PRII
od kliz en í	PRSI
od kliz ova t	PRII
od klon i t	PRII
od klop ova t	PRII
od klopýt a t	PRII
od kloň ova t	PRII
od klus a t	PRII
od klán ě t	PRII
od kláp ě t	PRII
od klíz e n í	PRISI
od klíz e t	PRII
od klíž i t	PRII
od koj i t	PRII
od kolíb a t	PRII
od komand ova t	PRII
od kop a t	PRII
od kop á v a t	PRSSII
od kouk a t	PRII
od koup i t	PRII
od krout i t	PRII
od krád a t	PRII
od krý t	PRI
od krý v a t	PRSII
od kulh a t	PRII
od kul i t	PRII
od kup ova t	PRII
od kutál e t	PRII
od kvap i t	PRII
od kvét a t	PRII
od kých nou t	PRII
od kýv a t	PRII
od kýv nou t	PRII
od lad i t	PRII
od laď ova t	PRII
od les n i t	PRSII
od les ň ova t	PRSII
od let ě t	PRII
od lič ova t	PRII
od liš i t	PRII
od liš n ý	PRSI
od liš n ě	PRSI
od liš ova t	PRII
od log ová n í	PRSSI
od lom i t	PRII
od loud a t	PRII
od loud i t	PRII
od loup a t	PRII
od loup nou t	PRII
od loup á v a t	PRSSII
od louč i t	PRII
od lož i t	PRII
od lup ova t	PRII
od luč ova t	PRII
od lák a t	PRII
od lám a t	PRII
od lét a t	PRII
od lét á v a t	PRSSII
od lé v a t	PRSII
od léz t	PRI
od lí t	PRI
od líč i t	PRII
od mast i t	PRII
od mlouv a t	PRII
od mlč e t	PRII
od moc n i t	PRSII
od moc ň ova t	PRSII
od mont ova t	PRII
od mot a t	PRII
od mot á v a t	PRSSII
od moč i t	PRII
od mršt i t	PRII
od mršť ova t	PRII
od myk a t	PRII
od mysl e t	PRII
od mysl i t	PRII
od mýšl e t	PRII
od měň ova t	PRII
od měř i t	PRII
od měř ova t	PRII
od na uč i t	PPRII
od na uč ova t	PPRII
od nos i t	PRII
od náš e t	PRII
o dou t	PRI
od pad a t	PRII
od pad nou t	PRII
od pad á v a t	PRSSII
od pal ova t	PRII
od pař i t	PRII
od pař ova t	PRII
od pečet i t	PRII
od pečeť ova t	PRII
od pil ova t	PRII
od pis ova t	PRII
od plat i t	PRII
od plav a t	PRII
od plav i t	PRII
od plaz i t	PRII
od pliv nou t	PRII
od pliv ova t	PRII
od plomb ova t	PRII
od ply nou t	PRII
od plác e t	PRII
od plíž i t	PRII
od po moc i	PPRI
od po máh a t	PPRII
od po rouč e t	PPRII
od po slouch a t	PPRII
od po slouch á v a t	PPRSSII
od pout a t	PRII
od poušt ě t	PRII
od po víd aj íc í	PPRSSI
od po věď	PPR
od po zor ova t	PPRII
od poč i v a dl o	PRISISS
od prac ova t	PRII
od prac ová v a t	PRSSII
od prav i t	PRII
od pros i t	PRII
od proš ova t	PRII
od prásk nou t	PRII
od prýsk a t	PRII
od prýsk nou t	PRII
od prýsk á v a t	PRSSII
od pump ova t	PRII
od pust i t	PRII
od puz ova t	PRII
od pušt ěn í	PRSI
od pál i t	PRII
od pír a t	PRII
od písk a t	PRII
od písk nou t	PRII
od rad i t	PRII
od raz i t	PRII
od raz ova t	PRII
o drb a t	PRII
o drh nou t	PRII
od rod i l ec	PRISI
od rod i t	PRII
od ruš ova t	PRII
od ryp ova t	PRII
od ráž e t	PRII
od rýp a t	PRII
od rýp á v a t	PRSSII
od rý t	PRI
od rý v a t	PRSII
od růst a t	PRII
od sek a t	PRII
od sek á v a t	PRSSII
od skak ova t	PRII
od skoč i t	PRII
od slouž i t	PRII
od sluh ova t	PRII
od soud c ova t	PRSII
od soud i t	PRII
od souv a c í	PRISI
od souz en ý	PRSI
od spěch a t	PRII
od start ova t	PRII
od stiň ova t	PRII
od ston a t	PRII
od stoup i t	PRII
od stran i t	PRII
od stran ěn í	PRSI
od straň ova t	PRII
od straš ova t	PRII
od strk a t	PRII
od strk ova t	PRII
od strk á v a t	PRSSII
od stroj i t	PRII
od stroj ova t	PRII
od stup ň ova t	PRSII
od stín i t	PRII
od stěh ova t	PRII
od střel i t	PRII
od střel ova t	PRII
od střík nou t	PRII
od sun ova t	PRII
od suz ova t	PRII
od syp a t	PRII
od syp á v a t	PRSSII
od sák nou t	PRII
od sá t	PRI
od sá v a t	PRSII
od síř i t	PRII
od sýp a t	PRII
od tah a t	PRII
od tah ova t	PRII
od tanc ova t	PRII
od tlač i t	PRII
od tlouc i	PRI
od tlouk a t	PRII
od toč i t	PRII
od trh nou t	PRII
od trh ova t	PRII
od tuš i t	PRII
od táh nou t	PRII
od téc i	PRI
od ték a t	PRII
od u mír a t	PPRII
od u mř í t	PPRII
od uč i t	PRII
od val ova t	PRII
od va nou t	PRII
od vaz ova t	PRII
od vař i t	PRII
od vař ova t	PRII
od vel e t	PRII
od vesl ova t	PRII
od vlh nou t	PRII
od vléc i	PRI
od vlék a t	PRII
od vlík a t	PRII
od vod n i t	PRSII
od vod ň ova t	PRSII
od vol á v a t	PRSSII
od vrac e n í	PRISI
od vrac e t	PRII
od vrh nou t	PRII
od vrh ova t	PRII
od vrávor a t	PRII
od vál e t	PRII
od vá t	PRI
od váz a t	PRII
od véz t	PRI
od víj e t	PRII
od větr a t	PRII
od vš iv i t	PRSII
od vš iv ova t	PRSII
od z broj i t	PPRII
od z broj ova t	PPRII
od zn í t	PRII
od zn í v a t	PRISII
od z pě v ova t	PPRSII
od zvon i t	PRII
od zván ě t	PRII
o dí t	PRI
o dí v a t	PRSII
od čar ova t	PRII
od čep ova t	PRII
od čerp a t	PRII
od čerp á v a t	PRSSII
od čin i t	PRII
od čiň ova t	PRII
o dě n ý	PRSI
od řez á v a t	PRSSII
od řez á v á n í	PRSSSSI
od říc i	PRI
od řík á n í	PRSSI
od řík á v a t	PRSSII
o dř í t	PRII
od říz nu t í	PRSII
od šifr ova t	PRII
od škod n i t	PRSII
od škrt nou t	PRII
od škrt á v a t	PRSSII
od šněr ova t	PRII
od šoup nou t	PRII
od šour a t	PRII
od šroub ova t	PRII
od štip ova t	PRII
od štíp a t	PRII
od štíp nou t	PRII
od štíp á v a t	PRSSII
od štěp i t	PRII
od šup ova t	PRII
o fouk nou t	PRII
o haz ova t	PRII
oheň	R
o hlad i t	PRII
o hlaš ova t	PRII
o hled a t	PRII
o hluch nou t	PRII
o hluš i t	PRII
o hluš ova t	PRII
o hluš uj íc í	PRSSI
o hlás i t	PRII
o hláv k a	PRII
o hlíd a t	PRII
o hmat a t	PRII
o hn a t	PRII
o hobl ova t	PRII
o hobl ová v a t	PRSSII
o hod i t	PRII
o hol i t	PRII
o hrab a n ý	PRISI
o hrab a t	PRII
o hrab ova t	PRII
o hrad i t	PRII
o hran ič i t	PRSII
o hraz ova t	PRII
o hr nou t	PRII
o hrom i t	PRII
o hrom ova t	PRII
o hroz i t	PRII
o hrož ova t	PRII
o hryz a n ý	PRISI
o hryz a t	PRII
o hryz ek	PRI
o hryz nou t	PRII
o hryz ova t	PRII
o hrá t	PRI
o hrá v a t	PRSII
o hyzd i t	PRII
o hán ě t	PRII
o ház e t	PRII
o háč k ova t	PRIII
o hýb a t	PRII
o hřá t	PRI
o je t	PRI
o jíd a t	PRII
o jížd ě t	PRII
o kal i t	PRII
o kap a t	PRII
o kartáč ova t	PRII
ok at ě	IPI
o klep a t	PRII
o klep nou t	PRII
o klep á v a t	PRSSII
o klesť ova t	PRII
o klešť ova t	PRII
o klov a t	PRII
o klát i t	PRII
ok o	IP
o kol k ova t	PRIII
o kol n ost	PRSS
o kol n í	PRSI
o kol o	PRS
o kol ík ova t	PRSII
o kop a t	PRII
o kop á v a t	PRSSII
o kor a t	PRII
o kouk a t	PRII
o kouk nou t	PRII
o kouk á v a t	PRSSII
o kous a t	PRII
o kous á v a t	PRSSII
o kouzl i t	PRII
o kořen i t	PRII
o kraš l ova t	PRSII
o krouh a t	PRII
o krouh á v a t	PRSSII
o krouž k ova t	PRIII
o kráj e t	PRII
o kráš l i t	PRSII
o kuk ova t	PRII
o kul at i t	PRSII
o kys el i t	PRRII
o křik ova t	PRII
o lam ova t	PRII
olej	R
olej ova t	RII
o liz ova t	PRII
o loup a t	PRII
o loup i t	PRII
o loup á v a t	PRSSII
o lup ova t	PRII
o lám a t	PRII
o lín a t	PRII
o lít a t	PRII
o líz a t	PRII
o líz nou t	PRII
o mak a t	PRII
o mak á v a t	PRSSII
o mal ova t	PRII
o mam ova t	PRII
o mast i t	PRII
o maz a t	PRII
o mačk a t	PRII
o mdl í t	PRII
o mdl í v a t	PRISII
o met a t	PRII
o mez en í	PRSI
o mez en ý	PRSI
o mez ova t	PRII
o mez uj íc í	PRSSI
o mešk a t	PRII
o mešk á v a t	PRSSII
o mil ost n i t	PRSSII
o mlad i t	PRII
o mlaz ova t	PRII
o mlouv a t	PRII
o mluv n ě	PRSI
o mlád nou t	PRII
o mlát i t	PRII
o ml í t	PRII
o mlž i t	PRII
o modř i t	PRII
o mot a t	PRII
o mot á v a t	PRSSII
o moč i t	PRII
o mrk nou t	PRII
o mrz e t	PRII
o mám en ý	PRSI
o mám i t	PRII
o máč e t	PRII
o míl a t	PRII
o mý t	PRI
o mý v a t	PRSII
o pad a t	PRII
o pad nou t	PRII
o pad á v a t	PRSSII
o pal ova t	PRII
o pancéř ova t	PRII
o pan ova t	PRII
o patr n ý	PRSI
o patr ova t	PRII
o patř en í	PRSI
o patř i t	PRII
o patř ova t	PRII
o pař i t	PRII
o pepř i t	PRII
o pepř ova t	PRII
oper ace	RS
oper ova t	RII
o pevn i t	PRII
o pil ova t	PRII
o pis ova t	PRII
o plak a t	PRII
o plak á v a t	PRSSII
o plat i t	PRII
o plod i t	PRII
o plot i t	PRII
o plác e t	PRII
o plét a t	PRII
o pot i t	PRII
o po třeb i t	PPRII
o po třeb ova t	PPRII
o po třeb ová v a t	PPRSSII
o poušt ě t	PRII
o po vrh nou t	PPRII
o po víd a t	PPRII
o pozd i t	PRII
o požď ova t	PRII
o prac ová v a t	PRSSII
o pras i t	PRII
o prask a t	PRII
o pr a t	PRII
o prav d ic k y	PRRSII
o prav i t	PRII
o praš ova t	PRII
o prch a t	PRII
o prud i t	PRII
o práš i t	PRII
o prýsk a t	PRII
o prýsk nou t	PRII
o prýsk á v a t	PRSSII
o prš e t	PRII
o ps a t	PRII
o pt a t	PRII
o pust i t	PRII
o pál i t	PRII
o pás a t	PRII
o péc i	PRI
o pék a t	PRII
o pík a t	PRII
o pín a t	PRII
o pě v a t	PRSII
o pě v ova t	PRSII
o raz í tk ova t	PRIRII
ordin ac e	RSI
ordin ova t	RII
organiz átor	RS
orient ač n í	RSSI
orient ova t	RII
o ros i t	PRII
o roub ova t	PRII
o rv a t	PRII
o rám ova t	PRII
o ráž e t	PRII
o rýs ova t	PRII
o rý t	PRI
o sch nou t	PRII
o sek a t	PRII
o sek á v a t	PRSSII
o sidl ova t	PRII
o slab en í	PRSI
o slab i t	PRII
o slad i t	PRII
o slav i t	PRII
o slav ova t	PRII
o slaz ova t	PRII
o slin i t	PRII
o slun i t	PRII
o slyš e t	PRII
o sláb nou t	PRII
o smaž i t	PRII
o sol i t	PRII
o souš e t	PRII
o soč i t	PRII
o soč ova t	PRII
o s prch ova t	PPRII
o stouz e t	PRII
o strouh a t	PRII
o strouh á v a t	PRSSII
ostr ý	RI
o střel ova t	PRII
ostř i t	RII
ostř í	RI
o stříl e t	PRII
o suš i t	PRII
o suš ova t	PRII
o svobod i t	PRII
o svoboz ova t	PRII
o svoboz uj íc í	PRSSI
o svíc en ost	PRSS
o svít i t	PRII
o svěc ova t	PRII
o taz ova t	PRII
o test ova t	PRII
o tes á v a t	PRSSII
ote vír a t	RRII
ote vř en ě	RRSI
o tip ova n ý	PRISI
o tisk nou t	PRII
o tisk ova t	PRII
o tlač i t	PRII
o tlouc i	PRI
o tlouk a t	PRII
o toč i t	PRII
o trav a	PRI
o trh a t	PRII
o trk a t	PRII
o tr nou t	PRII
otrok	R
otrok yn ě	RSI
otroč i t	RII
o tráv i t	PRII
o tup i t	PRII
o tup ě t	PRII
o tuž i t	PRII
o tuž ova t	PRII
ot vír a t	PRII
o táz a t	PRII
o táz k a	PRII
o táč e t	PRII
o téc i	PRI
o ték a t	PRII
o tír a t	PRII
o třep a t	PRII
o třep i t	PRII
o třás a t	PRII
o třás t	PRI
o třísk a t	PRII
o tř í t	PRII
o va nou t	PRII
o vaz ova t	PRII
o vař i t	PRII
o vař ova t	PRII
o vdov ě t	PRII
o vlaž ova t	PRII
o vlh nou t	PRII
o vlád a t	PRII
o vlád nou t	PRII
o v roub i t	PPRII
o vál e t	PRII
o vá t	PRI
o váz a t	PRII
o ví v a t	PRSII
o věs i t	PRII
o věř ova t	PRII
o věš en ý	PRSI
o věš e t	PRII
o věš ova t	PRII
oxid ova t	RII
o zař ova t	PRII
o z broj i t	PPRII
o zdrav i t	PRII
o zdrav ova t	PRII
o zelen ě n í	PRISI
o z kus i t	PPRII
o zlac ova t	PRII
o znač i t	PRII
o znač ova n ý	PRISI
o znač ova t	PRII
o znač uj íc í	PRSSI
o zob a t	PRII
o zoub k ova t	PRIII
o zv a t	PRII
o zář i t	PRII
o zýv a t	PRII
o čad i t	PRII
o čaloun i t	PRII
o čar ova t	PRII
o čar ová n í	PRSSI
o ček á v a n ě	PRSSISI
o ček á v a t	PRSSII
o čern i t	PRII
o čerň ova t	PRII
o čes a t	PRII
o čich a t	PRII
o čich nou t	PRII
o čich á v a t	PRSSII
o čist i t	PRII
o čisť ova t	PRII
o čišť ova t	PRII
oč k o	RIS
oč k ova t	RIII
o čmuch a t	PRII
o čmuch á v a t	PRSSII
o čoud i t	PRII
o čuch á v a t	PRSSII
o čum ova t	PRII
o číh nou t	PRII
o čísl ova t	PRII
o čísl ová v a t	PRSSII
o řez a t	PRII
o šetř i t	PRII
o šetř ova c í	PRISI
o šetř ov n a	PRSSI
o šid i t	PRII
o škleb ova t	PRII
oškliv ý	RI
o škrob i t	PRII
o škvař i t	PRII
o šlap a t	PRII
o šoup a t	PRII
o šplích a t	PRII
o šplích nou t	PRII
o štip ova t	PRII
o štíp a t	PRII
o štíp nou t	PRII
o švindl ova t	PRII
o ší t	PRI
o ťuk a t	PRII
o ťuk á v a t	PRSSII
o žeh nou t	PRII
o žeh ova t	PRII
o žen i t	PRII
o žr a t	PRII
o žvýk a t	PRII
o žíh a t	PRII
o žín a t	PRII
o ží v a t	PRSII
pach a tel	RIS
pacht ova t	RII
pad aj íc í	RSSI
pad nou t	RII
pa děl a t	PRII
pak	R
pa kůň	PR
pal b a	RII
pal ič k ova t	RSIII
pamat ova t	RII
památ k a	RII
paměť	R
pancéř ova t	RII
pan ova t	RII
pan áč ek	RSI
pan áč k ova t	RSIII
pan í	RI
parcel ova t	RII
parfém	R
parfém ova t	RII
park ova t	RII
park ov iště	RSR
parod ova t	RII
parád i t	RII
patl a t	RII
patř i t	RII
patř ič n ě	RSSI
pavouk	R
pavouč ek	RI
pař i t	RII
paš ova t	RII
paž e	RI
pejs ek	RI
peníz e	RI
pepř	R
pepř i t	RII
perl a	RI
perl eť ář sk ý	RSSII
perl i t	RII
per o	RS
pes	R
pevn ost	RS
pevn ě	RI
pečet i t	RII
peč liv ost	RSS
peč ova t	RII
pilot ova t	RII
pink a t	RII
pink nou t	RII
pipl a t	RII
pisk l av ě	RSSI
pitom ě t	RII
pitv a t	RII
pižl a t	RII
placht a	RI
placht i t	RII
plak a t	RII
pla n ouc í	RSSI
pla nou t	RII
plat i t	RII
plat n ý	RSI
plav a t	RII
plav ec	RI
plav i t	RII
plav k y	RII
plaz	R
plaz i t	RII
plač k y	RII
plač íc í	RSI
plaš i t	RII
plen i t	RII
plesk a t	RII
plesk a čk a	RIRI
plesk nou t	RII
plesk á n í	RSSI
plesn iv ý	RSI
plesn iv ě	RSI
plesn iv ě t	RSII
plev el i t	RRII
pleš at ě t	RSII
pliv a t	RII
pliv nou t	RII
pln i t	RII
pln o	RS
pln ý	RI
pln ě	RI
ploch a	RI
plod	R
plod n ý	RSI
plomb ova t	RII
ply nou t	RII
plác aj íc í	RSSI
plác a t	RII
plác nou t	RII
plán	R
plán ova n ý	RISI
plán ová n í	RSSI
plát c e	RSI
plát ek	RI
plát ova t	RII
plés t	RI
plí t	RI
plíž i t	RII
po baf á v a t	PRSSII
po bav i t	PRII
po bli nk a t	PRSII
po bloud i t	PRII
po blouzn i t	PRII
po blázn i t	PRII
po blí t	PRI
po bod a t	PRII
po bod nou t	PRII
po bol í v a t	PRISII
po bour a t	PRII
po bouř i t	PRII
po boř i t	PRII
po bož n ý	PRSI
po bratř i t	PRII
po brouk á v a t	PRSSII
po bruk ova t	PRII
po brynd a t	PRII
po buř ova t	PRII
po bád a t	PRII
po bý t	PRI
po bý v a t	PRSII
poc en í	RSI
po chcíp a t	PRII
po checht á v a t	PRSSII
po chleb ova t	PRII
po chod i t	PPII
po chop en í	PRSI
po chop i t	PRII
po chop i teln ý	PRISI
po chop ova t	PRII
po chov á v a t	PRSSII
po chut n a t	PRSII
po chval a	PRI
po chvál i t	PRII
po chyb a	PRI
po chyb i t	PRII
po chyb n ost	PRSS
po chyb ova t	PRII
po chyb ova č n ě	PRISSI
po chyc ova t	PRII
po chyt a t	PRII
po chyt nou t	PRII
po chyt á v a t	PRSSII
po cint a n ý	PRISI
po cit	PR
po ciť ova t	PRII
po ct i v ost	PRISS
po ct i v ý	PRISI
po ct i v ě	PRISI
po ct í t	PRII
po ct í v a t	PRISII
po cuch a t	PRII
po cukr ova t	PRII
po cvič i t	PRII
po cák a t	PRII
po cít i t	PRII
po dař i t	PRII
pod barv i t	PRII
pod cen i t	PRII
pod chyt i t	PRII
pod chyt nou t	PRII
pod dimenz ova t	PRII
pod dol ova t	PRII
pode hní v a t	PRSII
pode jí t	PRI
pode ml í t	PRII
pode pis ova t	PRII
pode ps a t	PRII
pode pír a t	PRII
pode př í t	PRII
pode t nou t	PIII
pode zd í t	PRII
pod fouk nou t	PRII
pod hod i t	PRII
pod hrab a t	PRII
pod hrab á v a t	PRSSII
pod hr nou t	PRII
pod je t	PRI
pod jížd ěj íc í	PRRSI
pod jížd ě t	PRII
pod kas a t	PRII
pod klouz nou t	PRII
pod klouz á v a t	PRSSII
pod kluz ova t	PRII
pod kop a t	PRII
pod kop á v a t	PRSSII
pod kuř ova t	PRII
pod lam ova t	PRII
pod let ě t	PRII
pod li t in a	PRISI
pod lož i t	PRII
pod lé v a t	PRSII
pod léz a t	PRII
pod léz t	PRI
pod lí t	PRI
pod lí v a t	PRSII
pod mal ová v a t	PRSSII
pod mast i t	PRII
pod maz a t	PRII
pod maz á v a t	PRSSII
pod mrač i t	PRII
pod mín i t	PRII
pod mín ěn ý	PRSI
pod nik	PR
pod nik aj íc í	PRSSI
pod nik a t	PRII
pod nik a tel sk ý	PRISII
pod nik nou t	PRII
pod něc ova t	PRII
po doj i t	PRII
po do tk nou t	PPRII
pod pich ova t	PRII
pod pis ova t	PRII
pod plav a t	PRII
pod pál i t	PRII
pod pích nou t	PRII
pod raz i t	PRII
po draž i t	PRII
po drb a t	PRII
pod rob n ost	PRSS
pod rob ova t	PRII
po dráp a t	PRII
po drážd i t	PRII
po drážd ěn í	PRSI
po drážd ěn ě	PRSI
pod ráž e t	PRII
pod rý t	PRI
pod rý v a t	PRSII
pod růst a t	PRII
po drž e t	PRII
pod strk ova t	PRII
pod stroj i t	PRII
pod stroj ova t	PRII
pod strč i t	PRII
pod sun ova t	PRII
pod syp a t	PRII
pod syp á v a t	PRSSII
pod sýp a t	PRII
pod trh nou t	PRII
pod trh nu t ý	PRSII
pod trh ova t	PRII
pod trh á v a t	PRSSII
pod tunel ova t	PRII
pod téc i	PRI
po dup a t	PRII
po dup nou t	PRII
po dup ova t	PRII
po dup á v a t	PRSSII
pod vaz ova t	PRII
pod vol ova t	PRII
pod voz ek	PRI
pod vrac e t	PRII
pod vrh nou t	PRII
pod vrh ova t	PRII
pod vrt nou t	PRII
pod vrt á v a t	PRSSII
pod vrát i t	PRII
pod váz a t	PRII
pod zim	PR
pod zim ek	PRI
pod zim n í	PRSI
po díl e t	PRII
po dí t	PRI
po dív a n á	PRISS
po dív a t	PRII
po děd i t	PRII
po děk ova t	PRII
po děl a t	PRII
po děl ova t	PRII
po děs i t	PRII
pod řad n ý	PRSI
pod řaz ova t	PRII
pod řek nou t	PRII
pod řiz ova t	PRII
pod říc i	PRI
pod říd i t	PRII
po dřím nou t	PRII
po dř í t	PRII
pod říz nou t	PRII
pod škrt nou t	PRII
pod ší t	PRI
pod ší v a t	PRSII
po fouk a t	PRII
po frk á v a t	PRSSII
po fuk ova t	PRII
po fňuk á v a t	PRSSII
po gum ova t	PRII
po han ě n ý	PRISI
po has nou t	PRII
po has ín a t	PRSII
po haz ova t	PRII
po hek á v a t	PRSSII
po hlad i t	PRII
po hlav n ost	PRSS
po hlav í	PRI
po hled	PR
po hled a t	PRII
po hled n ý	PRSI
po hled á v a t	PRSSII
po hled ě t	PRII
po hlin ík ova t	PRSII
po hlt i t	PRII
po hléd nou t	PRII
po hlíd a t	PRII
po hlíž e t	PRII
po hn a t	PRII
po hnoj i t	PRII
po hněv a t	PRII
po hod i t	PRII
po hon i t	PRII
po hop k á v a t	PRISSII
po hops á v a t	PRSSII
po host i t	PRII
po houp a t	PRII
po hovoř i t	PRII
po hrab a t	PRII
po hrab ova t	PRII
po hrab á v a t	PRSSII
po hrd a t	PRII
po hrd nou t	PRII
po hroz i t	PRII
po hryz a t	PRII
po hryz nou t	PRII
po hryz á v a t	PRSSII
po hrá t	PRI
po hyb ova t	PRII
po hád k a	PRII
po hán ě t	PRII
po ház e t	PRII
po hřeb n í	PRSI
po hřeš i t	PRII
po hřeš ova t	PRII
point ova t	RII
po jedn a t	PRII
po jedn á n í	PRSSI
po jedn á v aj íc í	PRSSSSI
po j e t í	PRIII
po jezd i t	PRII
po jišt ěn í	PRSI
po jišť ova t	PRII
po jmen ova t	PRII
po jím a t	PRII
po jím á n í	PRSSI
po jí t	PRI
po kap a t	PRII
po kap á v a t	PRSSII
po kaz i t	PRII
po kec a t	PRII
po klad n í	PRSI
po klep nou t	PRII
po klep á v a t	PRSSII
po kles	PR
po kles a t	PRII
po kles á v a t	PRSSII
po klon i t	PRII
po klon k ova t	PRIII
po klop i t	PRII
po klus á v a t	PRSSII
po klás t	PRI
po koléb a t	PRII
po kolíb a t	PRII
po kos i t	PRII
po kous a t	PRII
po koř i t	PRII
po koř ova t	PRII
po kož k a	PRII
po krop i t	PRII
po kruc ova t	PRII
po kráj e t	PRII
po krý t	PRI
po krč i t	PRII
po kuk ova t	PRII
po kulh á v a t	PRSSII
po kác e t	PRII
po kál e t	PRII
po kár a t	PRII
po kýv a t	PRII
po kýv nou t	PRII
po křik ova t	PRII
po křiv i t	PRII
po křiv ova t	PRII
po lap i t	PRII
pol ar iz ova t	RSSII
po lask a t	PRII
po lecht a t	PRII
po lecht á v a t	PRSSII
po lek a t	PRII
po lept a t	PRII
po lept á v a t	PRSSII
po let ova t	PRII
po lichot i t	PRII
po lit ova t	PRII
po li t í	PRII
polk nou t	RII
pol ovin a	RII
pol ovič n í	RISI
po lož k a	PRII
po lám an ý	PRSI
po lám a t	PRII
po lé v a t	PRSII
po lí t	PRI
po mal ova t	PRII
po mast i t	PRII
po mat en ý	PRSI
po maz a t	PRII
po mazl i t	PRII
po maz á v a t	PRSSII
po mačk a t	PRII
po maďar št i t	PRSII
po mil ova t	PRII
po mlask ova t	PRII
po mlouv a t	PRII
po mluv i t	PRII
po mlát i t	PRII
po modl i t	PRII
po modř i t	PRII
po moč i t	PRII
po mrk ova t	PRII
po mrk á v a t	PRSSII
po mrz nou t	PRII
po mst í t	PRII
po muchl a t	PRII
po mysl e t	PRII
po mysl i t	PRII
po máh a t	PRII
po más t	PRI
po mích a t	PRII
po mýl i t	PRII
po mýšl e t	PRII
po měd i t	PRII
po měr n ý	PRSI
po měr n ě	PRSI
po na uč i t	PPRII
po nech a t	PRII
po nech á v a t	PRSSII
po nič i t	PRII
po niž ova t	PRII
po noc ova t	PRII
po noř en í	PRSI
po noř ova t	PRII
po níž en í	PRSI
po níž i t	PRII
po ob naž i t	PPRII
po ob rát i t	PPRII
po ode jí t	PPRI
po od hal i t	PPRII
po od hr nou t	PPRII
po od je t	PPRI
po od lož i t	PPRII
po od stoup i t	PPRII
po o prav i t	PPRII
po ote vír a t	PRRII
po ote vř í t	PRRII
popel av ě t	RSII
popel i t	RII
po pich ova t	PRII
po pis	PR
po pis ova t	PRII
po plach	PR
po plac ova t	PRII
po plak a t	PRII
po plat ek	PRI
po plat i t	PRII
po plaš i t	PRII
po plen i t	PRII
po plesk a t	PRII
po pliv a t	PRII
po plác a t	PRII
po plác á v a t	PRSSII
po plés t	PRI
po po hn a t	PPRII
po po jí t	PPRI
po po léz t	PPRI
po po nés t	PPRI
po po strk á v a t	PPRSSII
po po tah ova t	PPRII
po pouz e t	PRII
po poušt ě t	PRII
po po véz t	PPRI
po po víd a t	PPRII
po po šoup nou t	PPRII
po prask a t	PRII
po prask ova t	PRII
po prask á v a t	PRSSII
po pr a t	PRII
po prav ova t	PRII
po praš ova t	PRII
po prch á v a t	PRSSII
po pros i t	PRII
po prsk a t	PRII
po práš i t	PRII
po práš k ova t	PRIII
po ps a t	PRII
po pt a t	PRII
po pt á v a t	PRSSII
po pud i t	PRII
po puk a t	PRII
popular iz ova n ý	RSISI
po pust i t	PRII
po puz ova t	PRII
po pál i t	PRII
po pás t	PRI
po pích a t	PRII
po pích nou t	PRII
po pín a t	PRII
po pír a t	PRII
po pě v ova t	PRSII
po přá t	PRI
po př í t	PRII
po rad a	PRI
po rad c e	PRSI
po rad n a	PRSI
po ran i t	PRII
po ran ěn í	PRSI
po ran ěn ý	PRSI
po raz i t	PRII
po rob i t	PRII
po rod i t	PRII
po ros i t	PRII
po rouč e t	PRII
po roz um ě n í	PPRISI
po rub a t	PRII
po ruč i t	PRII
po ruč ník ova t	PRSII
po ruš i t	PRII
po ruš i teln ý	PRISI
po ruš ova t	PRII
po rv a t	PRII
po ráž e t	PRII
po rýp a t	PRII
po s chov á v a t	PPRSSII
po sed ě t	PRII
po sek a t	PRII
po sek nou t	PRII
po sek á v a t	PRSSII
po ser out k a	PRRII
po se čk a t	PPRII
po se čk á n í	PPRSSI
po sil ova t	PRII
po skak ova t	PRII
po skoč i t	PRII
po skvrn i t	PRII
po skvrň ova t	PRII
po skyt nou t	PRII
po skyt ova t	PRII
po sl a n ec	PRISI
po sled n í	PRSI
po slin i t	PRII
po slouch a t	PRII
po slouž i t	PRII
po sluch ač	PRS
po sluh ova t	PRII
po sluš n ě	PRSI
po smut n ě t	PRSII
po smí v a t	PRSII
po s níd a t	PPRII
po sol i t	PRII
po souz en í	PRSI
po s prav i t	PPRII
po srk á v a t	PRSSII
po s tah ova t	PPRII
po sta v en ý	PRSSI
po stač i t	PRII
po stač ova t	PRII
po stač uj íc í	PRSSI
po stih nou t	PRII
po stih ova t	PRII
po stih uj íc í	PRSSI
po ston á v a t	PRSSII
po stoup i t	PRII
po straš i t	PRII
po strk ova t	PRII
po strk á v a t	PRSSII
po stroj i t	PRII
po stroj ova t	PRII
po struh ova t	PRII
po strč i t	PRII
po stup ova t	PRII
po stá t	PRI
po stýsk a t	PRII
po střik ova t	PRII
po střík a t	PRII
po střík nou t	PRII
po střík á v a t	PRSSII
po stříl e t	PRII
po suz ova t	PRII
po svít i t	PRII
po svěc ova t	PRII
po svět i t	PRII
po syp a t	PRII
po syp á v a t	PRSSII
po síl a t	PRII
po síl i t	PRII
po sýp a t	PRII
pot	R
po tah ova t	PRII
po tem n ě t	PRSII
potenc iál	RS
po tisk nou t	PRII
pot i t	RII
po tlač i t	PRII
po tlač ova t	PRII
po tlouc i	PRI
po tlouk a t	PRII
po trav in a	PRSI
po tref en ý	PRSI
po trest a t	PRII
po trh a t	PRII
po trh nou t	PRII
po trh ova t	PRII
po trh á v a t	PRSSII
po trp ě t	PRII
po trv a t	PRII
po tráp i t	PRII
po tuch nou t	PRII
po tul ova t	PRII
po tup i t	PRII
po tvoř i t	PRII
po tvrd i t	PRII
po tvrz en í	PRSI
po tvrz ova t	PRII
po tvrz ová n í	PRSSI
po táh nou t	PRII
po táz a t	PRII
po týr a t	PRII
po těš en í	PRSI
po těš en ý	PRSI
po těš i t	PRII
po těš ova t	PRII
po třeb n ý	PRSI
po třeb ova t	PRII
po třep a t	PRII
po třep á v a t	PRSSII
po třešt i t	PRII
po třás a t	PRII
po třísk a t	PRII
po tř í t	PRII
po u kaz ova t	PPRII
po u káz a t	PPRII
po ulič ní	PRS
pout a t	RII
pout ník	RS
pout o	RS
po uč i t	PRII
po uč n ě	PRSI
po uč ova t	PRII
poušt ě t	RII
poušť	R
po u ží v a t	PPRSII
po vad i t	PRII
po vad nou t	PRII
po val eč ův	PRSI
po val i t	PRII
po vař i t	PRII
po vesel i t	PRII
po večeř e t	PRII
po vléc i	PRI
po vlék a t	PRII
po vlík a t	PRII
po vod eň	PRI
po vol an ý	PRSI
po vol a t	PRII
po vol en í	PRSI
po vol ova t	PRII
po vol á n í	PRSSI
po vol á v a t	PRSSII
po voz i t	PRII
po vrch	PR
po vrh nou t	PRII
po v sta t	PPRI
po v stá v a t	PPRSII
po vy léz t	PPRI
po vy ráž e t	PPRII
po vy skak ova t	PPRII
po vy skoč i t	PPRII
po vyš ova t	PRII
po vz bud i t	PPRII
po vz buz en í	PPRSI
po vz buz ova t	PPRII
po vz dych a t	PPRII
po vz dych á v a t	PPRSSII
po vz náš e t	PPRII
po vz nés t	PPRI
po vál e t	PRII
po vápn i t	PRII
po vá t	PRI
po váz a t	PRII
po víd a t	PRII
po ví t	PRI
po věd ě t	PRII
po věr a	PRI
po věs i t	PRII
po větř í	PRI
po věř i t	PRII
po věř ova t	PRII
po všim nou t	PRII
po za myk a t	PPRII
po za sta v i t	PPRSII
po za týk a t	PPRII
po z bý t	PPRI
po z bý v a t	PPRSII
pozd i t	RII
pozd n í	RSI
po zdrav	PR
po zdrav ova t	PRII
po z drž e t	PPRII
po z drž ova t	PPRII
po zdvih a t	PRII
po zdvih nou t	PRII
po zdvih ova t	PRII
pozd ě	RI
po ze pt a t	PPRII
po z has ín a t	PPRSII
po zlac ova t	PRII
po zlat i t	PRII
po z měň ova t	PPRII
po znam en a t	PRSII
po znam en á v a t	PRSSSII
po znač i t	PRII
po znám k a	PRII
po zor	PR
po zor ova t	PRII
po z pě v ova t	PPRSII
po z trác e t	PPRII
po zv a t	PRII
po zv á n í	PRSSI
po zů stá v a t	PPRSII
po čern i t	PRII
po čest n ý	PRSI
po čist i t	PRII
po čišť ova t	PRII
po čk a t	PRII
po čmár a t	PRII
po čur a t	PRII
po čár a t	PRII
po číh a t	PRII
po ďob a t	PRII
po řez a t	PRII
po řiz ova t	PRII
po řád ek	PRI
po řád n ý	PRSI
po řád n ě	PRSI
po říd i t	PRII
po šept á v a t	PRSSII
po šin ova t	PRII
po škleb ova t	PRII
po škoz en ý	PRSI
po škoz ova t	PRII
po škrob i t	PRII
po škub a t	PRII
po škub nou t	PRII
po škub ova t	PRII
po škub á v a t	PRSSII
po šoup nou t	PRII
po špin i t	PRII
po šplouch a t	PRII
po šplích a t	PRII
po štv a t	PRII
po štíp a t	PRII
po švih ova t	PRII
po ší v a t	PRSII
po šťouch nou t	PRII
po šťour a t	PRII
po ťap a t	PRII
po žad ova t	PRII
po žal ova t	PRII
po žehn a n ý	PRISI
po žehn a t	PRII
po žeh nou t	PRII
po žehn á n í	PRSSI
po žehn á v a t	PRSSII
po žeh ova t	PRII
po žád á n í	PRSSI
po žín a t	PRII
po ží v a t	PRSII
prach	R
prach y	RI
prac ova t	RII
prac ov ník	RSS
prac ová n í	RSSI
prac uj íc í	RSSI
pr a dl en a	RISSI
pra děd ek	PRI
pra děd eček	PRS
pra les	PR
pramen i t	RII
pra mál o	PRS
pr a n í	RISI
pras e	RI
pras i t	RII
prask a t	RII
prask nou t	RII
prask ot	RS
prav d a	RRI
prav i dl o	RISS
prav i t	RII
prav ý	RI
pra věk ý	PRI
praš ník ov ý	RSSI
praž i t	RII
prch a t	RII
prch a v ý	RISI
prch nou t	RII
prd nou t	RII
prepar ova t	RII
privat iz ac e	RSSI
privat iz ova t	RSII
pro bd í t	PRII
problem at ik a	RSSI
problem at ič n ost	RSSSS
pro blesk nou t	PRII
pro blesk ova t	PRII
pro blesk á v a t	PRSSII
problém	R
problém ov ý	RSI
pro blýsk a t	PRII
pro blýsk nou t	PRII
pro bod a t	PRII
pro bod nou t	PRII
pro bod á v a t	PRSSII
pro boj ova t	PRII
pro boj ová v a t	PRSSII
pro bouz e t	PRII
pro boř i t	PRII
pro bud i t	PRII
pro bíh a t	PRII
pro běh nou t	PRII
pro běl i t	PRII
pro běl á v a t	PRSSII
pro ced i t	PRII
proces	R
pro cez ova t	PRII
pro chlad nou t	PRII
pro chlast a t	PRII
pro chod i t	PPII
pro choz en ý	PRSI
pro chví v a t	PRSII
pro chvě t	PRI
pro cház e t	PPII
pro cház k a	PPII
pro cl í t	PRII
pro cour a t	PRII
pro cvak a t	PRII
pro cvak nou t	PRII
pro cvak á v a t	PRSSII
pro cvič i t	PRII
pro cvič ova t	PRII
pro cít i t	PRII
pro dlouž en á	PRSS
pro dlouž en ý	PRSI
pro dlouž i t	PRII
pro dluž ova t	PRII
pro duk c e	PRSI
pro duk ova t	PRII
pro duk č n í	PRSSI
pro děl á v a t	PRSSII
pro děr av ě t	PRSII
pro dř í t	PRII
profil ova t	RII
pro filtr ova t	PRII
pro financ ová v á n í	PRSSSSI
pro flák a t	PRII
pro flák nou t	PRII
pro fouk a t	PRII
pro fouk nou t	PRII
pro fouk á v a t	PRSSII
pro fuk ova t	PRII
pro gram	PR
pro haz ova t	PRII
pro hlaš ova t	PRII
pro hled a t	PRII
pro hlub ova t	PRII
pro hlás i t	PRII
pro hláš en ý	PRSI
pro hléd a t	PRII
pro hléd nou t	PRII
pro hlíd a t	PRII
pro hlíd k a	PRII
pro hmat á v a t	PRSSII
pro hmát nou t	PRII
pro hní t	PRI
pro hní v a t	PRSII
pro hod i t	PRII
pro hospod ař i t	PRSII
pro hrab ova t	PRII
pro hrab á v a t	PRSSII
pro hryz a t	PRII
pro hryz nou t	PRII
pro hád a t	PRII
pro hán ě t	PRII
pro ház e t	PRII
pro hýb a t	PRII
pro hřeš i t	PRII
pro hřeš ova t	PRII
pro hřá t	PRI
pro jedn a t	PRII
pro jedn á v a t	PRSSII
pro jekt	PR
pro jekt ant	PRS
pro jekt ova t	PRII
pro je t	PRI
pro jev i t	PRII
pro jev ova t	PRII
pro jezd i t	PRII
pro jíd a t	PRII
pro jím a t	PRII
pro jí t	PRI
pro jížd ě t	PRII
pro kaz a teln ě	PRISI
pro kaz ova t	PRII
pro klep a t	PRII
pro klest i t	PRII
pro klesť ova t	PRII
pro klešť ova t	PRII
pro klouz nou t	PRII
pro klov a t	PRII
pro klub a t	PRII
pro kluz ova t	PRII
pro klád a t	PRII
pro klí t	PRI
pro kmit nou t	PRII
pro kop a t	PRII
pro kop nou t	PRII
pro kop á v a t	PRSSII
pro kouk nou t	PRII
pro kous a t	PRII
pro kous nou t	PRII
pro kous á v a t	PRSSII
pro kouř i t	PRII
pro krm i t	PRII
pro kus ova t	PRII
pro kvét a t	PRII
pro káz a t	PRII
pro křeh nou t	PRII
pro křeh nu t í	PRSII
pro křič e t	PRII
pro len oš i t	PRSII
pro let ě t	PRII
pro lis ova t	PRII
pro list ova t	PRII
pro lom i t	PRII
pro lož i t	PRII
pro lám a t	PRII
pro lé v a t	PRSII
pro léz a t	PRII
pro léz t	PRI
pro lín a t	PRII
pro lí t	PRI
pro lít a t	PRII
pro lít nou t	PRII
pro lí v a t	PRSII
pro mast i t	PRII
pro mas ír ova t	PRSII
pro maz a t	PRII
pro mačk a t	PRII
pro mačk á v a t	PRSSII
pro mař i t	PRII
pro mešk a t	PRII
pro mlouv a t	PRII
pro mls a t	PRII
pro mluv i t	PRII
pro mlč e t	PRII
pro mlč ova t	PRII
pro modr a t	PRII
pro mok nou t	PRII
pro moč en ý	PRSI
pro moč i t	PRII
pro mrh a t	PRII
pro mysl e t	PRII
pro máz nou t	PRII
pro máč e t	PRII
pro mích a t	PRII
pro míj e t	PRII
pro mý t	PRI
pro mýt i t	PRII
pro mý v a t	PRSII
pro měn a	PRI
pro měn i t	PRII
pro měň ova t	PRII
pro měř i t	PRII
pro na jím a t	PPRII
pro na jím a teln ý	PPRISI
pro ná sled ova t	PPRII
pro nés t	PRI
pro pacht ova t	PRII
pro pad a t	PRII
pro pad l o	PRSS
pro pad nou t	PRII
pro pad á v a t	PRSSII
pro pal ova t	PRII
pro pař i t	PRII
pro paš ova t	PRII
pro pich ova t	PRII
pro pil ova t	PRII
pro pis ova t	PRII
pro plat i t	PRII
pro plav a t	PRII
pro plav i t	PRII
pro plác e t	PRII
pro plét á v a t	PRSSII
pro plíž i t	PRII
pro plýtv a t	PRII
pro pot i t	PRII
pro poušt ě n í	PRISI
pro poušt ě t	PRII
pro po víd a t	PPRII
pro prac ova t	PRII
pro prac ová v a t	PRSSII
pro ps a t	PRII
pro puk a t	PRII
pro puk nou t	PRII
pro pust i t	PRII
pro pál i t	PRII
pro péc i	PRI
pro pích a t	PRII
pro pích nou t	PRII
pro pích á v a t	PRSSII
pro pír a t	PRII
pro pěst ova t	PRII
pro půjč ova t	PRII
pro raz i t	PRII
pro rv a t	PRII
pro ráž e t	PRII
pro rý t	PRI
pro rý v a t	PRSII
pro růst a t	PRII
pro sak ova t	PRII
pro sch nou t	PRII
pro sed ě t	PRII
pro sek a t	PRII
pro sek nou t	PRII
pro sek á v a t	PRSSII
pros i t	RII
pro skak ova t	PRII
pro skoč i t	PRII
pro slav i t	PRII
pro slech nou t	PRII
pro sl ov	PRS
pro slun i t	PRII
pro slíd i t	PRII
pro sn í t	PRII
pro sol i t	PRII
pro soud i t	PRII
pro spekul ova t	PRII
pro ston a t	PRII
pro strk a t	PRII
pro strk ova t	PRII
pro strk á v a t	PRSSII
pro strč i t	PRII
pro stud ova t	PRII
pro stud ová n í	PRSSI
pro styd nou t	PRII
pro stěh ova t	PRII
pro střed ek	PRI
pro střed k ova t	PRIII
pro střed í	PRI
pro střel i t	PRII
pro střel ova t	PRII
pro střih á v a t	PRSSII
pro střík nou t	PRII
pro stříl e t	PRII
pro svít i t	PRII
pro syp a t	PRII
pro syp á v a t	PRSSII
pro sák nou t	PRII
pro síř i t	PRII
pro sýp a t	PRII
pro tah ova t	PRII
pro tanc ova t	PRII
pro tisk nou t	PRII
pro tlach a t	PRII
pro tlač i t	PRII
pro tlač ova t	PRII
pro tlouc i	PRI
pro tlouk a t	PRII
pro t nou t	PIII
pro toč i t	PRII
pro trp ě t	PRII
pro táh nou t	PRII
pro táč e t	PRII
pro téc i	PRI
pro třás t	PRI
pro tř í t	PRII
prout k ař i t	RISII
prouž ek	RI
prouž k ova t	RIII
pro val ova t	PRII
pro va nou t	PRII
pro vin i t	PRII
pro vlh nou t	PRII
pro vlh č i t	PRSII
pro vléc i	PRI
pro vlék a t	PRII
pro vlík a t	PRII
pro vok ova t	PRII
pro vol a t	PRII
pro vol á v a t	PRSSII
pro von ě t	PRII
pro voň ova t	PRII
pro vrt a t	PRII
pro vrt á v a t	PRSSII
pro vz dych a t	PPRII
pro vál e t	PRII
pro váž e t	PRII
pro ví v a t	PRSII
pro větr a t	PRII
pro věř i t	PRII
pro zař ova t	PRII
pro z kouš e t	PPRII
pro z pyt ova t	PPRII
pro z pě v ova t	PPRSII
pro z rad i t	PPRII
pro z raz ova t	PPRII
pro zář i t	PRII
pro zív a t	PRII
pro čechr a t	PRII
pro čechr á v a t	PRSSII
pro ček a t	PRII
pro čes a t	PRII
pro čist i t	PRII
pro čišť ova t	PRII
pro řek nou t	PRII
pro řez a t	PRII
pro řez á v a t	PRSSII
pro říc i	PRI
pro říd nou t	PRII
pro šed iv ě t	PRSII
pro šlap a t	PRII
pro šlap á v a t	PRSSII
pro šleh nou t	PRII
pro šláp nou t	PRII
pro šoup a t	PRII
pro špik ova t	PRII
pro štíp a t	PRII
pro štíp nou t	PRII
pro ší t	PRI
pro ší v a t	PRSII
pro šťouch a t	PRII
pro šťouch nou t	PRII
pro ťuk a t	PRII
pro žr a t	PRII
pro žvan i t	PRII
pro žír a t	PRII
pro ží v a t	PRSII
prs	R
prsk a t	RII
prsk nou t	RII
prst	R
prst en	RS
pruh	R
pruh ova t	RII
pruž i t	RII
pruž n ost	RSS
pr á del n í	RSSSI
pr á dl o	RSSS
prásk a t	RII
prásk nou t	RII
pr á t	RSI
práv n ic tv í	RSSSI
práv n í	RSI
práv n ík	RSS
prázdn iny	RS
prázdn ot a	RSI
prázdn ý	RI
práš i t	RII
práš k ova t	RIII
prýsk nou t	RII
prš e t	RII
prů hled n ý	PRSI
ps a c í	RISI
ps in a	RSI
ps isk o	RSS
ps á t	RSI
ps í	RI
ps íčk ův	RSI
pt á t	RSI
pud	R
pud i t	RII
pudr ova t	RII
puk a t	RII
puk nou t	RII
pump ova t	RII
pust i t	RII
pust nou t	RII
pust oš i t	RSII
put ova t	RII
puz en í	RSI
puč e t	RII
pytel	R
pytl ač i t	RSII
pytl ova t	RII
pytl ík ova t	RSII
pyš n i t	RSII
pyš n ý	RSI
pyš n ě	RSI
pách nou t	RII
pál i t	RII
pán	R
pár a t	RII
pár ek	RI
pár k ova t	RIII
pár ova t	RII
pás a t	RII
pás t	RI
pátr a t	RII
pátr á n í	RSSI
páč i t	RII
péc i	RI
pér o	RS
pér ova t	RII
pích nut ý	RRI
píp a t	RII
píp nou t	RII
pí seň	RS
písk a t	RII
písk nou t	RII
písk ová n í	RSSI
pých a t	RII
pěch ova t	RII
pěn i t	RII
pěst i t	RII
pěst ova t	RII
pře bal i t	PRII
pře barv i t	PRII
pře bol e t	PRII
pře brod i t	PRII
pře bruš ova t	PRII
pře bud ova t	PRII
pře bud ová v a t	PRSSII
pře básn i t	PRII
pře básn ěn ý	PRSI
pře bíl i t	PRII
pře bý t	PRI
pře bý v a t	PRSII
pře ceň ova t	PRII
pře chlad i t	PRII
pře chlaz ova t	PRII
pře chod i t	PPII
pře chov á v a t	PRSSII
pře chvál i t	PRII
pře chyl ova t	PRII
pře cház e t	PPII
pře cp a t	PRII
pře cp á v a t	PRSSII
před chůd c e	PPPI
přede hrá t	PRI
přede hřá t	PRI
přede hřá t ý	PRII
přede je t	PRI
přede jí t	PRI
přede ps a t	PRII
před form ova n ý	PRISI
před haz ova t	PRII
před hod i t	PRII
před hon i t	PRII
před hán ě t	PRII
před hří v a t	PRSII
před je t	PRI
před jížd ě t	PRII
před klon i t	PRII
před let ě t	PRII
pře dluž i t	PRII
pře dlážd i t	PRII
před nož i t	PRII
před náš k a	PRII
před nés t	PRI
před pis ova t	PRII
před plat i t	PRII
před plác e t	PRII
před po klád a t	PPRII
před po víd a t	PPRII
pře draž i t	PRII
pře draž ova t	PRII
pře drážd i t	PRII
pře drž e t	PRII
pře drž ova t	PRII
před stih nou t	PRII
před stih ova t	PRII
před sun ova t	PRII
před tanc ova t	PRII
před tanč i t	PRII
před tisk nou t	PRII
před tisk ova t	PRII
před urč i t	PRII
před vař i t	PRII
před vař ova t	PRII
před vol b a	PRII
před vol á v a t	PRSSII
před váleč n ý	PRSI
před víd a t	PRII
před znam en a t	PRSII
před znam en á v a t	PRSSSII
před z pě v ova t	PPRSII
pře děl a t	PRII
pře děl i t	PRII
pře děl ova t	PRII
pře děl á v a t	PRSSII
pře děl á v á n í	PRSSSSI
před řík a t	PRII
před řík á v a t	PRSSII
pře dř í t	PRII
pře form ova t	PRII
pře frč e t	PRII
pře haz ova t	PRII
pře hlas ova t	PRII
pře hlaš ova t	PRII
pře hlás i t	PRII
pře hlíd a t	PRII
pře hnoj i t	PRII
pře hod i t	PRII
pře hop k a t	PRIII
pře hop k ova t	PRIII
pře hrab a t	PRII
pře hrab ova t	PRII
pře hrab á v a t	PRSSII
pře hrad i t	PRII
pře hraz ova t	PRII
pře hr nou t	PRII
pře hryz a t	PRII
pře hryz nou t	PRII
pře hryz á v a t	PRSSII
pře hráb nou t	PRII
pře hrá t	PRI
pře hrá v a t	PRSII
pře hust i t	PRII
pře hán ě t	PRII
pře ház e t	PRII
pře hýb a t	PRII
pře hřá t	PRI
pře hří v a t	PRSII
pře je t	PRI
pře jmen ova t	PRII
pře jíd a t	PRII
pře jím a t	PRII
pře jížd ě t	PRII
pře kap ova t	PRII
pře kaz i t	PRII
pře kaz ova t	PRII
pře klep nou t	PRII
pře klon i t	PRII
pře klop i t	PRII
pře klán ě t	PRII
pře kláp ě t	PRII
pře kol k ova t	PRIII
pře kon a t	PRII
pře kon stru ova t	PRRII
pře kontrol ova t	PRII
pře kon á v a t	PRSSII
pře kop a t	PRII
pře kop nou t	PRII
pře kop á v a t	PRSSII
pře kous a t	PRII
pře kous nou t	PRII
pře kraj ova t	PRII
pře krač ova t	PRII
pře krm i t	PRII
pře kroj i t	PRII
pře krout i t	PRII
pře kruc ová n í	PRSSI
pře kráj e t	PRII
pře krás n ý	PRSI
pře krý t	PRI
pře krý v a t	PRSII
pře kus ova t	PRII
pře kyp ova t	PRII
pře kys el i t	PRRII
pře káž e t	PRII
pře káž k a	PRII
pře křič e t	PRII
pře křič ova t	PRII
pře kříž i t	PRII
pře lad i t	PRII
pře lak ova t	PRII
pře lam ova t	PRII
pře let ova t	PRII
pře lešt i t	PRII
pře list ova t	PRII
pře lom i t	PRII
pře lousk a t	PRII
pře lousk nou t	PRII
pře lož i t	PRII
pře lám a t	PRII
pře lét nou t	PRII
pře lét á v a t	PRSSII
pře léz a t	PRII
pře léz t	PRI
pře lí t	PRI
pře lít a t	PRII
pře lít á v a t	PRSSII
pře lí v a t	PRSII
pře líz a t	PRII
pře líč i t	PRII
pře mal ova t	PRII
pře mast i t	PRII
pře mlouv a t	PRII
pře mlouv á n í	PRSSI
pře mluv i t	PRII
pře ml í t	PRII
pře mnoh ý	PRI
pře moc i	PRI
pře mont ova t	PRII
pře mosť ova n ý	PRISI
pře mot a t	PRII
pře mot á v a t	PRSSII
pře moudř e t	PRII
pře mrz nou t	PRII
pře míst i t	PRII
pře mísť ova t	PRII
pře měn i t	PRII
pře měň ova t	PRII
pře měř i t	PRII
pře měř ova t	PRII
pře nech a t	PRII
pře nech á v a t	PRSSII
pře noc ova t	PRII
pře náš e t	PRII
pře nés t	PRI
pře orient ova t	PRII
pře pad a t	PRII
pře pad á v a t	PRSSII
pře pal ova t	PRII
pře paž ova t	PRII
pře pepř i t	PRII
pře pil ova t	PRII
pře plat i t	PRII
pře plav a t	PRII
pře plav i t	PRII
pře plav ova t	PRII
pře pln i t	PRII
pře plác e t	PRII
pře plét a t	PRII
pře plň ova t	PRII
pře prac ova t	PRII
pře prac ová v a t	PRSSII
pře pr a t	PRII
pře prav i t	PRII
pře prav ova t	PRII
pře praž i t	PRII
pře prch nou t	PRII
pře prch á v a t	PRSSII
pře pudr ova t	PRII
pře pust i t	PRII
pře péc i	PRI
pře pék a t	PRII
pře pích a t	PRII
pře pín a t	PRII
pře půl i t	PRII
pře raz i t	PRII
pře raz í tk ova t	PRIRII
pře rod i t	PRII
pře rost š í	PRSI
pře ruš en í	PRSI
pře ruš i t	PRII
pře rv a t	PRII
pře ráž e t	PRII
pře rý t	PRI
pře rý v a n ě	PRSISI
pře rý v a t	PRSII
pře růst a t	PRII
pře sah ova t	PRII
pře sed ě t	PRII
pře sek a t	PRII
pře sek nou t	PRII
pře sek á v a t	PRSSII
pře skak ova t	PRII
pře skoč i t	PRII
pře slabik ova t	PRII
pře slad i t	PRII
pře slaz ova t	PRII
pře slouž i t	PRII
pře sluh ova t	PRII
přesn ý	RI
přesn ě	RI
pře sol i t	PRII
pře sp a t	PRII
pře sp á v a t	PRSSII
pře sta t	PRI
pře stoup i t	PRII
pře stoup nou t	PRII
pře stroj i t	PRII
pře stroj ova t	PRII
pře stud ova t	PRII
pře stup ova t	PRII
pře styl iz ova t	PRSII
pře stá t	PRI
pře stěh ová v a t	PRSSII
pře sun ova t	PRII
pře syc ova t	PRII
pře syp á v a t	PRSSII
pře syt i t	PRII
pře sáh nou t	PRII
pře sídl i t	PRII
pře sídl ova t	PRII
pře sýp a t	PRII
pře tav i t	PRII
pře tisk nou t	PRII
pře tlouc i	PRI
pře tlouk a t	PRII
pře tlumoč i t	PRII
pře t nou t	PIII
pře toč i t	PRII
pře trh a t	PRII
pře trh nou t	PRII
pře trh á v a t	PRSSII
pře trp ě t	PRII
pře trumf nou t	PRII
pře trv a t	PRII
pře trv á v aj íc í	PRSSSSI
pře trén ova t	PRII
pře trž en í	PRSI
pře tvař ova t	PRII
pře tvoř i t	PRII
pře tvoř ova t	PRII
pře tvář e t	PRII
pře táh nou t	PRII
pře táč e t	PRII
pře téc i	PRI
pře ték a t	PRII
pře tír a t	PRII
pře tíž en í	PRSI
pře tíž i t	PRII
pře těž ova t	PRII
pře třep a t	PRII
pře třás a t	PRII
pře tříd i t	PRII
pře uč ova t	PRII
pře val i t	PRII
pře vaz ova t	PRII
pře vař i t	PRII
pře vař ova t	PRII
pře vlád a t	PRII
pře vléc i	PRI
pře vlék a t	PRII
pře vlík a t	PRII
pře vrh nou t	PRII
pře vrh ova t	PRII
pře vrstv i t	PRII
pře vrstv ova t	PRII
pře vrát i t	PRII
pře v těl i t	PPRII
pře v těl ova t	PPRII
pře vy chov a t	PPRII
pře vys ok o	PRIS
pře vál e t	PRII
pře vá t	PRI
pře váz a t	PRII
pře váž e t	PRII
pře véz t	PRI
pře věs i t	PRII
pře zd í t	PRII
pře zd í v a t	PRISII
pře zim ova t	PRII
pře z koum a t	PPRII
pře z kouš e t	PPRII
pře znač k ova t	PRIII
pře zou t	PRI
pře zrá t	PRI
pře zv a t	PRII
pře zář i t	PRII
pře čerp á v a t	PRSSII
pře čes a t	PRII
pře čin	PR
pře čist i t	PRII
pře čišť ova t	PRII
pře čísl ova t	PRII
pře řad i t	PRII
pře řaz ova t	PRII
pře řaď ova t	PRII
pře řek nou t	PRII
pře řez a t	PRII
pře řez á v a t	PRSSII
pře říc i	PRI
pře řík a t	PRII
pře řík á v a t	PRSSII
pře říz nou t	PRII
pře škol i t	PRII
pře škol ova t	PRII
pře škrt a t	PRII
pře škrt nou t	PRII
pře škrt á v a t	PRSSII
pře škvař i t	PRII
pře šlap ova t	PRII
pře šlap á v a t	PRSSII
pře šlecht i t	PRII
pře šláp nou t	PRII
pře šmik nou t	PRII
pře štip ova t	PRII
pře štíp nou t	PRII
pře švih nou t	PRII
pře ší t	PRI
pře ší v a t	PRSII
pře žehl i t	PRII
pře žvyk ova t	PRII
pře žvýk a t	PRII
pře žvýk á v a t	PRSSII
pře ží v a t	PRSII
při bal i t	PRII
při bal ova t	PRII
při barv i t	PRII
při belh a t	PRII
při bliž n ě	PRSI
při bliž ova t	PRII
při blíž i t	PRII
při bod nou t	PRII
při bouch nou t	PRII
při bouch á v a t	PRSSII
při brous i t	PRII
při brzd i t	PRII
při bud ova t	PRII
při básn i t	PRII
při bý t	PRI
při bý v a t	PRSII
při cap a t	PRII
při cap k a t	PRIII
při cest ova t	PRII
při chvát a t	PRII
při chvát nou t	PRII
při chyst a t	PRII
při chyt a t	PRII
při chyt i t	PRII
při chyt nou t	PRII
při chyt á v a t	PRSSII
při cvál a t	PRII
při draž i t	PRII
při drk ot a t	PRSII
při drnc a t	PRII
při druž i t	PRII
při druž ova t	PRII
při dus i t	PRII
při děl a t	PRII
při děl i t	PRII
při děl ova t	PRII
při haz ova t	PRII
při hlad i t	PRII
při hlaz ova t	PRII
při hnoj i t	PRII
při hnoj ova t	PRII
při hobl ova t	PRII
při hop k a t	PRIII
při hop k ova t	PRIII
při hops a t	PRII
při hotov i t	PRII
při hrb i t	PRII
při hr nou t	PRII
při hrot i t	PRII
při hák ova t	PRII
při háč k ova t	PRIII
při hýb a t	PRII
při hřá t	PRI
při hřá v a t	PRSII
při hří v a t	PRSII
při j a t ý	PRIII
při jedn a t	PRII
při je t	PRI
při j e t í	PRIII
při juch a t	PRII
při jím ac í	PRSI
při jím aj íc í	PRSSI
při jím a t	PRII
při jím á n í	PRSSI
při jí t	PRI
při jížd ě t	PRII
při kap a t	PRII
při kaz ova t	PRII
při klap nou t	PRII
při klap ova t	PRII
při klep nou t	PRII
při klon i t	PRII
při klop i t	PRII
při klop ova t	PRII
při klopýt a t	PRII
při klus a t	PRII
při klán ě t	PRII
při kláp ě t	PRII
při klíž i t	PRII
při koléb a t	PRII
při kolíb a t	PRII
při kol ík ova t	PRSII
při koup i t	PRII
při kous nou t	PRII
při kouzl i t	PRII
při kořen i t	PRII
při kraj ova t	PRII
při kraš l ova t	PRSII
při krm ova t	PRII
při kroj i t	PRII
při kry t ý	PRII
při krád a t	PRII
při kráj e t	PRII
při kráš l i t	PRSII
při krý v a t	PRSII
při krč i t	PRII
při kulh a t	PRII
při kus ova t	PRII
při kutál e t	PRII
při kys el i t	PRRII
při kyv ova t	PRII
při káp nou t	PRII
při káz a t	PRII
při kýv nou t	PRII
při let ě t	PRII
při loud a t	PRII
při lák a t	PRII
při lát a t	PRII
při lét a t	PRII
při lé v a t	PRSII
při léz a t	PRII
při lín a t	PRII
při lí v a t	PRSII
při líz a t	PRII
při mast i t	PRII
při mhouř i t	PRII
při mhuř ova t	PRII
při mlouv a t	PRII
při mluv i t	PRII
při mont ova t	PRII
při mot a t	PRII
při mraz i t	PRII
při mysl e t	PRII
při máz nou t	PRII
při mích a t	PRII
při mích á v a t	PRSSII
při mýšl e t	PRII
při měř en ost	PRSS
při měř en ý	PRSI
při měř i t	PRII
při nož i t	PRII
při nut i t	PRII
při nés t	PRI
při nýt ova t	PRII
při o dí t	PPRI
při o dí v a t	PPRSII
při ostř i t	PRII
při o tráv i t	PPRII
při pacht ova t	PRII
při pad a t	PRII
při pad nou t	PRII
při pad á v a t	PRSSII
při pal ova t	PRII
při pamat ova t	PRII
při paž i t	PRII
při paž ova t	PRII
při pepř i t	PRII
při pich ova t	PRII
při pil ova t	PRII
při pis ova t	PRII
při plat i t	PRII
při plav a t	PRII
při plaz i t	PRII
při plác e t	PRII
při plác nou t	PRII
při plét a t	PRII
při pout a t	PRII
při pout á v a t	PRSSII
při poušt ě t	PRII
při pozd i t	PRII
při pozd í v a t	PRISII
při praž i t	PRII
při prásk nou t	PRII
při ps a t	PRII
při pudr ova t	PRII
při pump ova t	PRII
při pust i t	PRII
při put ova t	PRII
při páj e t	PRII
při péc i	PRI
při pék a t	PRII
při pích á v a t	PRSSII
při pín a t	PRII
při raz i t	PRII
při roub ova t	PRII
při rovn á n í	PRSSI
při ráž e t	PRII
při ráž k a	PRII
při růst a t	PRII
při sch nou t	PRII
při sek a t	PRII
při sek nou t	PRII
při sek á v a t	PRSSII
při skak ova t	PRII
při skoč i t	PRII
při skříp nou t	PRII
při slad i t	PRII
při slaz ova t	PRII
při sluh ova t	PRII
při sol i t	PRII
při soud i t	PRII
při spoř i t	PRII
při spí v a t	PRSII
při spěch a t	PRII
při spěch á v a t	PRSSII
při spě t	PRI
při steh ova t	PRII
při stih nou t	PRII
při stih ova t	PRII
při stoup i t	PRII
při strk á v a t	PRSSII
při stroj ova t	PRII
při strč i t	PRII
při stá t	PRI
při stá v a t	PRSII
při suz ova t	PRII
při svíc en í	PRSI
při syp a t	PRII
při syp á v a t	PRSSII
při sá t	PRI
při sá v a t	PRSII
při sýp a t	PRII
při tah ova t	PRII
při tanc ova t	PRII
při tanč i t	PRII
při tes á v a t	PRSSII
při tisk nou t	PRII
při tisk ova t	PRII
při tišt ěn ý	PRSI
při tlač i t	PRII
při tlouc i	PRI
při tlouk a t	PRII
při tlum i t	PRII
při toč i t	PRII
při tref i t	PRII
při trh nou t	PRII
při tuh nou t	PRII
při tuh ova t	PRII
při tul i t	PRII
při tuž i t	PRII
při tuž ova t	PRII
při ték a t	PRII
při tíž i t	PRII
při těž ova t	PRII
při tř í t	PRII
při uč ova t	PRII
při val i t	PRII
při val ova t	PRII
při vandr ova t	PRII
při vař i t	PRII
při vař ova t	PRII
při vesl ova t	PRII
při vlast ň ova t	PRSII
při vléc i	PRI
při vlék a t	PRII
při vol a t	PRII
při vol i t	PRII
při vol á n í	PRSSI
při von ě t	PRII
při vrávor a t	PRII
při v těl i t	PPRII
při v těl ova t	PPRII
při vy děl a t	PPRII
při váb i t	PRII
při vál e t	PRII
při vá t	PRI
při váz a t	PRII
při váž e t	PRII
při véz t	PRI
při vír a t	PRII
při vít a t	PRII
při vý děl ek	PPRI
při věš ova t	PRII
při vř í t	PRII
při zd í t	PRII
při zn á n í	PRSSI
při zn á v a t	PRSSII
při zv a t	PRII
při čar ova t	PRII
při čes a t	PRII
při čes á v a t	PRSSII
při čin i t	PRII
při čiň ova t	PRII
při člen i t	PRII
při čleň ova t	PRII
při čmár a t	PRII
při čuch nou t	PRII
při řad i t	PRII
při řaz ova t	PRII
při řez a t	PRII
při řez á v a t	PRSSII
při řít i t	PRII
při říz nou t	PRII
při škol i t	PRII
při škrob i t	PRII
při škrt i t	PRII
při škvař i t	PRII
při šlap á v a t	PRSSII
při šláp nou t	PRII
při šněr ova t	PRII
při šour a t	PRII
při špendl i t	PRII
při šroub ova t	PRII
při štip ova t	PRII
při štíp nou t	PRII
při šum ě t	PRII
při ší t	PRI
při ší v a t	PRSII
při žen i t	PRII
přá n í	RSI
přá t	RI
pří jem	PR
pří kaz	PR
přím i t	RII
přím o	RS
přím ý	RI
pří ruč í	PRI
pří sah a	PRI
pří sah a t	PRII
pří sluš en stv í	PRSSI
pří sluš e t	PRII
pří sluš ník	PRS
pří spě v ek	PRSI
pří stroj	PR
pří stup	PR
př í t	RII
přítel	R
přítel íček	RS
pří zvuk ova t	PRII
příč i t	RII
půjč i t	RII
půl	R
půl i t	RII
půl k a	RII
rab ova t	RII
rad i t	RII
rad ost	RS
rad ost n ě	RSSI
ran i t	RII
ran ěn ý	RSI
raz i t	RII
raz í tk o	RIRS
raž b a	RII
raž en í	RSI
rd í t	RII
re akc e	PRI
real it a	RII
real iz ova t	RSII
rebel ova t	RII
re cit ova t	PRII
redig ova t	RII
reduk ova t	RII
re form ova t	PRII
re form átor	PRS
registr ac e	RSI
registr ač n í	RSSI
registr ova t	RII
regul ace	RS
regul ova n ý	RISI
regul ova t	RII
re komand ova t	PRII
relat iv izová n í	RSSSI
re prezent ova t	PRII
re sign ova t	PRII
re vid ova t	PRII
rez av ě n í	RSISI
rez avě t	RSI
reál n ý	RSI
reál n ě	RSI
rmout i t	RII
rob i t	RII
rod	R
rod in a	RSI
rod in n ý	RSSI
rod i t	RII
rod ác k ý	RSII
rod ák	RS
roh	R
roh ova t	RII
roh ovin n ý	RISI
roj i t	RII
rok	R
rol ova t	RII
rol uj íc í	RSSI
romant ic k ý	RSII
román	R
ros i t	RII
ros ičk a	RSI
ros n ý	RSI
rost lin a	RSI
rost ou c í	RSSI
roub i t	RII
roub ova t	RII
rovin a	RI
rovn a t	RII
rovn ic e	RSI
rovn ost	RS
rovn ou	RS
roz bahn i t	PRII
roz bal i t	PRII
roz bal ova t	PRII
roz bod a t	PRII
roz bol e t	PRII
roz bour a t	PRII
roz bouř i t	PRII
roz boř i t	PRII
roz breč e t	PRII
roz bruč e t	PRII
roz buj e t	PRII
roz buš i t	PRII
roz běs n i t	PRSII
roz checht a t	PRII
roz chod i t	PPII
roz chrchl a t	PRII
roz chyt á v a t	PRSSII
roz cház e t	PPII
roz cour a t	PRII
roz cvič i t	PRII
roz cvič ova t	PRII
roz div oč i t	PRRII
roz dloub a t	PRII
roz drk ot a t	PRSII
roz drob i t	PRII
roz drol i t	PRII
roz dráp a t	PRII
roz drás a t	PRII
roz drážd i t	PRII
roz dup a t	PRII
roz dým a t	PRII
roz děl a t	PRII
roz děl i t	PRII
roz děl á v a t	PRSSII
roze chví v a t	PRSII
roze chvě t	PRI
roze dm ou t	PRSI
roze dř í t	PRII
roze hrá t	PRI
roze hrá v a t	PRSII
roze hřá t	PRI
roze hřá v a t	PRSII
roze hří v a t	PRSII
roze jí t	PRI
roze ml í t	PRII
roze pín a t	PRII
roze př í t	PRII
roze sch nou t	PRII
roze smut n i t	PRSII
roze smut n ě t	PRSII
roze smut ň ova t	PRSII
roze smá t	PRI
roze stl a t	PRII
roze stýl a t	PRII
roze t nou t	PIII
roze tř í t	PRII
roze vlá t	PRI
roze vír a t	PRII
roze vř e n ý	PRISI
roze vř í t	PRII
roze zn a t	PRII
roze zn á v a t	PRSSII
roze zn í t	PRII
roze zn í v a t	PRISII
roze zvuč e t	PRII
roze řv a t	PRII
roze štv a t	PRII
roze ší t	PRI
roz flák a n ý	PRISI
roz fouk a t	PRII
roz fouk nou t	PRII
roz fouk á v a t	PRSSII
roz fuk ova t	PRII
roz fňuk a t	PRII
roz hal i t	PRII
roz hal ova t	PRII
roz haz ova t	PRII
roz hlaš ova t	PRII
roz hlod a t	PRII
roz hlod á v a t	PRSSII
roz hlás i t	PRII
roz hod i t	PRII
roz hod n ý	PRSI
roz hod n ě	PRSI
roz horl i t	PRII
roz horl ova t	PRII
roz houk a t	PRII
roz houp a t	PRII
roz houp á v a t	PRSSII
roz hovor	PR
roz hovoř i t	PRII
roz hoz en ý	PRSI
roz hrab a t	PRII
roz hrab ova t	PRII
roz hrab á v a t	PRSSII
roz hran ič i t	PRSII
roz hran ič ova t	PRSII
roz hryz a t	PRII
roz hryz nou t	PRII
roz hryz á v a t	PRSSII
roz ház e t	PRII
roz hýb a t	PRII
roz hýb á v a t	PRSSII
roz hří v a t	PRSII
roz jas n i t	PRSII
roz jas ň ova t	PRSII
roz je t	PRI
roz jezd i t	PRII
roz ječ e t	PRII
roz jež i t	PRII
roz jizv i t	PRII
roz jás a t	PRII
roz kašl a t	PRII
roz kec a t	PRII
roz klap a t	PRII
roz kliž ova t	PRII
roz klov a t	PRII
roz klov nou t	PRII
roz klábos i t	PRII
roz klíž i t	PRII
roz koléb a t	PRII
roz koléb á v a t	PRSSII
roz kolíb a t	PRII
roz kolís a n ost	PRISS
roz kolís a t	PRII
roz kop a t	PRII
roz kop nou t	PRII
roz kouk á v a t	PRSSII
roz kous a t	PRII
roz kous nou t	PRII
roz kous á v a t	PRSSII
roz kraj ova t	PRII
roz kram ař i t	PRSII
roz kroj i t	PRII
roz kroj ova t	PRII
roz krád a t	PRII
roz kráj e t	PRII
roz kuch a t	PRII
roz kus ova t	PRII
roz kvas i t	PRII
roz kvés t	PRI
roz kvét a t	PRII
roz kyd a t	PRII
roz káz a t	PRII
roz kých a t	PRII
roz kýv nou t	PRII
roz kýv á v a t	PRSSII
roz křes a t	PRII
roz křik nou t	PRII
roz křik ova t	PRII
roz křáp nou t	PRII
roz lad i t	PRII
roz laď ova t	PRII
roz lept a t	PRII
roz lept á v a t	PRSSII
roz let ě t	PRII
roz liš en í	PRSI
roz liš ova c í	PRISI
roz liš ova t	PRII
roz lom i t	PRII
roz los ova t	PRII
roz loup a t	PRII
roz loup nou t	PRII
roz lousk a t	PRII
roz lousk nou t	PRII
roz lousk á v a t	PRSSII
roz louč en á	PRSS
roz louč en í	PRSI
roz louč i t	PRII
roz lup ova t	PRII
roz luč ova t	PRII
roz lušt i t	PRII
roz lušt ěn í	PRSI
roz lám a t	PRII
roz lét a t	PRII
roz lét á v a t	PRSSII
roz léz t	PRI
roz lí t	PRI
roz lít á v a t	PRSSII
roz lí v a t	PRSII
roz maz a t	PRII
roz mazl i t	PRII
roz mazl ova t	PRII
roz maz ova t	PRII
roz maz á v a t	PRSSII
roz mačk a t	PRII
roz met a t	PRII
roz met á v a t	PRSSII
roz mlouv a t	PRII
roz mluv i t	PRII
roz mlát i t	PRII
roz množ i t	PRII
roz množ ova t	PRII
roz mok nou t	PRII
roz mont ova t	PRII
roz mot á v a t	PRSSII
roz moč i t	PRII
roz mrh a t	PRII
roz mrz ova t	PRII
roz mysl e t	PRII
roz mysl i t	PRII
roz mách nou t	PRII
roz máh a t	PRII
roz máč e t	PRII
roz mích a t	PRII
roz mích á v a t	PRSSII
roz míst i t	PRII
roz mísť ova t	PRII
roz měk č i t	PRSII
roz měn i t	PRII
roz měň ova t	PRII
roz měň uj íc í	PRSSI
roz měř i t	PRII
roz měř ova t	PRII
roz nož i t	PRII
roz nož ova t	PRII
roz náš e t	PRII
roz nés t	PRI
roz nýt ova t	PRII
roz pad a t	PRII
roz pad a v ý	PRISI
roz pad nou t	PRII
roz pad á v a t	PRSSII
roz pal ova t	PRII
roz parcel ova t	PRII
roz par ova t	PRII
roz patl a t	PRII
roz pař ova t	PRII
roz paž ova t	PRII
roz pečet i t	PRII
roz pich ova t	PRII
roz pitv a t	PRII
roz plak a n ý	PRISI
roz plak a t	PRII
roz plaš i t	PRII
roz plesk nou t	PRII
roz plod i t	PRII
roz ploz ova t	PRII
roz ply nou t	PRII
roz plác nou t	PRII
roz plán ova t	PRII
roz plét a t	PRII
roz plýtv a t	PRII
roz plý v a t	PRSII
roz po síl a t	PPRII
roz pout a t	PRII
roz pout á v a t	PRSSII
roz poušt ě t	PRII
roz po víd a t	PPRII
roz prac ova t	PRII
roz prac ová v a t	PRSSII
roz prask a t	PRII
roz prask á v a t	PRSSII
roz praš ova t	PRII
roz prch nou t	PRII
roz prch á v a t	PRSSII
roz prsk nou t	PRII
roz prýsk a t	PRII
roz prš e t	PRII
roz pust i t	PRII
roz puč e t	PRII
roz pál i t	PRII
roz pár a t	PRII
roz péc i	PRI
roz pék a t	PRII
roz pích a t	PRII
roz pích nou t	PRII
roz pích á v a t	PRSSII
roz pěn i t	PRII
roz půjč i t	PRII
roz rad ost n i t	PRSSII
roz rad ova t	PRII
roz raz i t	PRII
roz ruš i t	PRII
roz ruš ova t	PRII
roz ry v n ý	PRSSI
roz ráž e t	PRII
roz rýp a t	PRII
roz rýp á v a t	PRSSII
roz rý t	PRI
roz rý v a t	PRSII
roz růst a t	PRII
roz různ i t	PRII
roz růzň ova t	PRII
roz sed ě t	PRII
roz sek a t	PRII
roz sek nou t	PRII
roz sek á v a t	PRSSII
roz skoč i t	PRII
roz slz e t	PRII
roz soud i t	PRII
roz ston a t	PRII
roz strk a t	PRII
roz strk á v a t	PRSSII
roz strouh a t	PRII
roz stup ova t	PRII
roz střel i t	PRII
roz střel ova t	PRII
roz střik ova t	PRII
roz střík a t	PRII
roz střík nou t	PRII
roz stříl e t	PRII
roz svít i t	PRII
roz svěc ova t	PRII
roz syp a t	PRII
roz sýp a t	PRII
roz tah a t	PRII
roz tah ova t	PRII
roz tanč i t	PRII
roz tav i t	PRII
roz tav ova t	PRII
roz taž en ý	PRSI
roz tep a t	PRII
roz tesk n i t	PRSII
roz tesk ň ova t	PRSII
roz tlouc i	PRI
roz tlouk a t	PRII
roz toč i t	PRII
roz trh a t	PRII
roz trh ova t	PRII
roz trh á v a t	PRSSII
roz troub i t	PRII
roz trub ova t	PRII
roz truš ova t	PRII
roz táh nou t	PRII
roz tá t	PRI
roz tá v a t	PRSII
roz táč e t	PRII
roz téc i	PRI
roz těk a t	PRII
roz třep a t	PRII
roz třep i t	PRII
roz třep ova t	PRII
roz třep á v a t	PRSSII
roz třiď ova t	PRII
roz třás a t	PRII
roz třás t	PRI
roz tříd i t	PRII
roz tříd ěn í	PRSI
roz třísk a t	PRII
roz třísk nou t	PRII
roz um	PR
roz um n ý	PRSI
roz um ář	PRS
roz um ě t	PRII
roz u téc i	PPRI
roz vad i t	PRII
roz val i t	PRII
roz val ova t	PRII
roz vaz ova t	PRII
roz vař ova t	PRII
roz vesel i t	PRII
roz vikl á v a t	PRSSII
roz viř ova t	PRII
roz vln i t	PRII
roz vlék a t	PRII
roz vod n i t	PRSII
roz vod ň ova t	PRSII
roz vrac e t	PRII
roz vrh nou t	PRII
roz vrh ova t	PRII
roz vrt a t	PRII
roz vrt á v a t	PRSSII
roz vrát i t	PRII
roz vá t	PRI
roz váz a t	PRII
roz váz á n í	PRSSI
roz váž e n ě	PRISI
roz váž e t	PRII
roz véz t	PRI
roz víj ej íc í	PRRSI
roz víj e t	PRII
roz vír a t	PRII
roz ví t	PRI
roz věs i t	PRII
roz větv en ý	PRSI
roz větv i t	PRII
roz větv ova t	PRII
roz věš ova t	PRII
roz vřísk a t	PRII
roz vřísk nou t	PRII
roz zl ob i t	PRSII
roz zuř i t	PRII
roz zuř ova t	PRII
roz zář i t	PRII
roz zív a t	PRII
roz čechr a t	PRII
roz čepýř i t	PRII
roz čert i t	PRII
roz čes a t	PRII
roz čes á v a t	PRSSII
roz čeř i t	PRII
roz člen i t	PRII
roz čleň ova t	PRII
roz čtvrt i t	PRII
roz řaz ova t	PRII
roz řed i t	PRII
roz řez a t	PRII
roz řez á v a t	PRSSII
roz řeď ova t	PRII
roz řeš en í	PRSI
roz řeš i t	PRII
roz řeš i teln ý	PRISI
roz šiř ova t	PRII
roz škleb i t	PRII
roz škrt á v a t	PRSSII
roz škub nou t	PRII
roz škub á v a t	PRSSII
roz škvař i t	PRII
roz šlap a t	PRII
roz šlap á v a t	PRSSII
roz šleh a t	PRII
roz šleh á v a t	PRSSII
roz šláp nou t	PRII
roz šmik a t	PRII
roz šněr ová v a t	PRSSII
roz šroub ova t	PRII
roz štíp a t	PRII
roz štíp nou t	PRII
roz štíp á v a t	PRSSII
roz štěp i t	PRII
roz štěp ova t	PRII
roz šum ě t	PRII
roz šíř en í	PRSI
roz šíř en ý	PRSI
roz šíř i t	PRII
roz žehn a t	PRII
roz žeh nou t	PRII
roz žeh ova t	PRII
roz žh av i t	PRSII
roz žh av ova t	PRSII
roz žmol i t	PRII
roz žmoul a t	PRII
roz žvatl a t	PRII
roz žvýk a t	PRII
roz žíh a t	PRII
roč n í	RSI
roč n ě	RSI
rub a t	RII
rud nou t	RII
rud ý	RI
rud ě	RI
ruk a	RI
rus	R
ruč i t	RII
ruš en í	RSI
ruš i t	RII
ruš n ý	RSI
ruš tin a	RSI
rv a č k a	RISII
rv á t	RSI
rv á č	RSS
ryb a	RI
ryb ař i t	RSII
ryb ičk a	RSI
rychl e	RI
rychl i t	RII
rychl ost	RS
rychl ý	RI
rys	R
rád c e	RSI
rám ec	RI
ráč ek	RI
rýh ova t	RII
rým ova t	RII
rýp a t	RII
rýs ova t	RII
rý t	RI
růst	R
různ i t	RII
růž e	RI
růž ičk ov ý	RSSI
růž ov ý	RSI
sabot áž	RS
sah a t	RII
s bal en í	PRSI
s bal i t	PRII
s bliž ova t	PRII
s blíž i t	PRII
s bratř ova t	PRII
s bubn ova t	PRII
s bíh a t	PRII
s běh nou t	PRII
s ced i t	PRII
scen ér i e	RSII
s cest ova t	PRII
s cez ova t	PRII
sch nou t	RII
s chop n ost	PRSS
s chop n ý	PRSI
s chov á v a t	PRSSII
s chraň ova t	PRII
s chrup a t	PRII
s chrup nou t	PRII
s chval ova c í	PRISI
s chval ova t	PRII
s chvál i t	PRII
s chyl ova t	PRII
s chyt á v a t	PRSSII
s cház e t	PPII
s chýl i t	PRII
s cuk nou t	PRII
s drh ova t	PRII
s druž i t	PRII
s druž ova t	PRII
s drát ova t	PRII
s díl e t	PRII
s dír a t	PRII
s děl en í	PRSI
s děl i t	PRII
s děl ova t	PRII
s děl á v a t	PRSSII
se běh nou t	PRII
se cvič i t	PRII
se cvič ova t	PRII
sed íc í	RSI
sed ě t	RII
se dř í t	PRII
se hrá n í	PRSI
se jím a t	PRII
se jí t	PRI
sek a t	RII
sekund ova t	RII
se lh a t	PRII
se lh á n í	PRSSI
se lh á v a t	PRSSII
se ml í t	PRII
se míl a t	PRII
sen	R
separ ova t	RII
se pis ova t	PRII
se pis ová n í	PRSSI
se pr a t	PRII
se rv a t	PRII
se sek a t	PRII
se sek nou t	PRII
se sek á v a t	PRSSII
se skoč i t	PRII
se skák a t	PRII
se smol i t	PRII
se souk a t	PRII
se sta v en ý	PRSSI
se strk ova t	PRII
se stroj i t	PRII
se stroj ova t	PRII
se strč i t	PRII
se styl iz ova t	PRSII
se stá v a t	PRSII
se střel i t	PRII
se střel ova t	PRII
se sun ova t	PRII
se syp a t	PRII
se syp á v a t	PRSSII
se sýp a t	PRII
se tm í t	PRII
se t nou t	PIII
se trv a l ý	PRISI
se trv a t	PRII
se trv á v a t	PRSSII
se třep a t	PRII
se třep á v a t	PRSSII
se třás a t	PRII
se třás t	PRI
se třás á v a t	PRSSII
se tř í t	PRII
se vř e n ě	PRISI
se vř í t	PRII
sez e n í	RISI
se zn a c í	PRISI
se zn a t	PRII
se zn á v a t	PRSSII
se zob a t	PRII
se zob nou t	PRII
se zob á v a t	PRSSII
se zv a t	PRII
se čk a t	PRII
se řad i t	PRII
se řaz ova t	PRII
se řaď ova t	PRII
se řez a t	PRII
se řiz ova t	PRII
se říz nou t	PRII
se šik ova t	PRII
se škleb i t	PRII
se šlap a t	PRII
se šlap ova t	PRII
se šleh a t	PRII
se š l ost	PPPP
se šláp nou t	PRII
se šmajd a t	PRII
se šmodrch a t	PRII
se šoup nou t	PRII
se šoup á v a t	PRSSII
se šplh a t	PRII
se šroub ova t	PRII
se štel ova n ý	PRISI
se šup ova t	PRII
se ší t	PRI
se ší v a t	PRSII
se žeh nou t	PRII
se žmol i t	PRII
se žmoul a t	PRII
se žr a t	PRII
se žvýk a t	PRII
se žvýk nou t	PRII
se žvýk á v a t	PRSSII
se žín a t	PRII
s fouk a t	PRII
s fouk nou t	PRII
s fouk á v a t	PRSSII
s fuk ova t	PRII
s fár a t	PRII
s haz ova t	PRII
s hlad i t	PRII
s hlaz ova t	PRII
s hled á v a t	PRSSII
s hléd nou t	PRII
s hlíž e t	PRII
s hní t	PRI
s hod i t	PRII
s hrab a t	PRII
s hrab ova t	PRII
s hrab ová n í	PRSSI
s hrab á v a t	PRSSII
s hrb i t	PRII
s hr nou t	PRII
s hr nu t í	PRSII
s hromažď ova t	PRII
s hromážd i t	PRII
s hráb nou t	PRII
s hán ě t	PRII
sil n ic e	RSSI
sil n ý	RSI
sil n ě	RSI
simul ova t	RII
sir k a	RII
s jedn oc ova t	PRRII
s jedn oc uj íc í	PRRSSI
s jedn ot i t	PRSII
s jedn á v a t	PRSSII
s je t	PRI
s jížd ě t	PRII
skal n í	RSI
s kap a t	PRII
s klad a tel	PRIS
s klad b a	PRII
s klad ova t	PRII
s klap nou t	PRII
s klap ova t	PRII
skl en ic e	RSSI
skl en ík	RSS
s klep a t	PRII
s klep á v a t	PRSSII
skl o	RS
s klon i t	PRII
s klop en ý	PRSI
s klop i t	PRII
s kloub i t	PRII
s klouz a t	PRII
s klouz nou t	PRII
s klouz á v a t	PRSSII
s kloň ova t	PRII
s klád a t	PRII
s klán ě t	PRII
s kláp ě t	PRII
s klát i t	PRII
s klíz e t	PRII
s klíč i t	PRII
skl íčk o	RSS
skok	R
s konc ova t	PRII
s kop nou t	PRII
s kos i t	PRII
s koul e t	PRII
s koup i t	PRII
s kous nou t	PRII
skoč i t	RII
s krout i t	PRII
s kruc ova t	PRII
s kráj e t	PRII
s kráp ě t	PRII
s krý t	PRI
s krý v a t	PRSII
s krč i t	PRII
s kul i t	PRII
s kup i t	PRII
s kup ova t	PRII
s kup ová v a t	PRSSII
skutek	R
skuteč n ost	RSS
skuteč n ý	RSI
s kutál e t	PRII
s kác e t	PRII
skál a	RI
s káp nou t	PRII
skýt a t	RII
skříp a t	RII
skříp nou t	RII
slabik ova t	RII
slab in a	RSI
slab ost	RS
slab oun c e	RSSI
slab ě	RI
slad c e	RSI
slad i t	RII
slad k ý	RII
slav i t	RII
slav n ý	RSI
slav n ě	RSI
sled ova t	RII
slep ic e	RSI
slep nou t	RII
slep ý	RI
s let	PR
s let ova t	PRII
s let ě t	PRII
s lev a	PRI
s lev i t	PRII
s lev ova t	PRII
slin i t	RII
s lis ova t	PRII
s lit ova t	PRII
s lit ová n í	PRSSI
s lič n ě	PRSI
s loup a t	PRII
s loup nou t	PRII
s louč i t	PRII
slouž i t	RII
s lož en in a	PRSSI
s lož i t	PRII
sluch	R
sluch á tk o	RSRS
slun eč n í	RSSI
slun i t	RII
s lup ova t	PRII
s luč ova t	PRII
sluš n ý	RSI
sluš n ě	RSI
služ ba	RI
služ b ičk ova t	RISII
služ eb n á	RSSS
služ eb n ě	RSSI
slz a	RI
slz e t	RII
sláb nou t	RII
slád nou t	RII
slám a	RI
s lát a t	PRII
sláv a	RI
s lét a t	PRII
s lét nou t	PRII
s lé v a t	PRSII
s léz a t	PRII
s líb a t	PRII
s lí t	PRI
s lít á v a t	PRSSII
s líz a t	PRII
s líz nou t	PRII
slých á v a t	RSSII
s maz a t	PRII
s mačk a t	PRII
smaž en ý	RSI
smaž i t	RII
s mil ova t	PRII
s mil ová v a t	PRSSII
s mlouv a	PRI
s mlouv a t	PRII
s mluv i t	PRII
s mlč e t	PRII
smol i t	RII
s mont ova t	PRII
s mot a t	PRII
s mot á v a t	PRSSII
s moč i t	PRII
smrk a t	RII
smrk áč	RS
s mrsk a t	PRII
s mrsk nou t	PRII
s mrsk ova t	PRII
s mrsk á v a t	PRSSII
s mr t	PRI
s mr t k a	PRIII
smut n o	RSS
smut n ě	RSI
smut n ě t	RSII
smá t	RI
s máč e t	PRII
s més t	PRI
s mích a t	PRII
s mý t	PRI
s mý v a t	PRSII
s mýšl e t	PRII
s měn a	PRI
s měn i t	PRII
s měň ova t	PRII
s niž ova t	PRII
s niž ová n í	PRSSI
s nos i t	PRII
snoub i t	RII
sn ova t	RII
s náš e t	PRII
s nés t	PRI
s níd a n ě	PRISI
s níd a t	PRII
sníh	R
sn í l k ovsk y	RISIRI
s ním a t	PRII
s ním ek	PRI
s ním k ova t	PRIII
s níž en í	PRSI
sol i t	RII
sond ova t	RII
sou cit n ý	PRSI
sou cit n ě	PRSI
sou cít i t	PRII
soud	R
soud c ova t	RSII
soud i t	RII
soud n í	RSI
sou hvězd í	PRI
souk a t	RII
souk en ic e	RSSI
sou střed i t	PRII
sou střed ěn í	PRSI
sou střeď ova t	PRII
sou vis ej íc í	PRRSI
sou vis e t	PRII
sou zn í t	PRII
sou čas n ý	PRSI
sou čas n ě	PRSI
sou část	PR
soč i t	RII
s pad nou t	PRII
s pal ova t	PRII
sp a n í	RISI
s patř i t	PRII
s pař i t	PRII
spekul at iv n í	RSSSI
spekul ova t	RII
s pil ova t	PRII
sp ink a t	RSII
s pis ova t	PRII
s pis ova tel	PRIS
s plat i t	PRII
s plat n ost	PRSS
s plav	PR
s plav i t	PRII
s plav n i t	PRSII
s plaš i t	PRII
s ply nou t	PRII
s plác a t	PRII
s plác e n í	PRISI
s plác e t	PRII
s plét a t	PRII
s plý v a t	PRSII
s plň ova t	PRII
sport ova t	RII
s po třeb ova t	PPRII
s pout a t	PRII
s poušt ě t	PRII
spoř i l ov sk ý	RISSII
spoř i t	RII
s po řád a t	PPRII
s prav i t	PRII
s prav ova t	PRII
s praž i t	PRII
s prch nou t	PRII
s prch ova t	PRII
s prásk nou t	PRII
s pust i t	PRII
s pách a t	PRII
s páj e t	PRII
s pál en išt ě	PRSSI
s pál i t	PRII
sp á n ek	RSSI
s pár a t	PRII
s pás a	PRI
s pás a t	PRII
s pás t	PRI
sp á t	RSI
s písk a t	PRII
spěch a t	RII
s pěch ova t	PRII
spě t	RI
spěš n ě	RSI
s raz i t	PRII
srdc e	RI
srk a t	RII
srk nou t	RII
s rol ova t	PRII
s roub i t	PRII
s rovn á n í	PRSSI
s roz um ě t	PPRII
sr á t	RSI
s ráž e t	PRII
s ráž k a	PRII
s růst a t	PRII
stabil iz ova t	RSII
s tah ova t	PRII
standard	R
standard iz ova t	RSII
standard n í	RSI
sta nic e	RSI
sta nou t	RII
star och	RS
star ost	RS
star ost a	RSI
star ost ova t	RSII
start ova t	RII
stač i t	RII
stař ec	RI
stař ík	RS
steh ova t	RII
s tep a t	PRII
steril iz ova t	RSII
s tes a t	PRII
s tes á v a t	PRSSII
stih nou t	RII
s tisk nou t	PRII
s tisk á v a t	PRSSII
s tlač en í	PRSI
s tlač i t	PRII
s tlač ova t	PRII
s tlouc i	PRI
s tlouk a t	PRII
stl á t	RSI
s tmel i t	PRII
s tmel ova t	PRII
stol ek	RI
stol eček	RS
stol n í	RSI
ston a t	RII
stop ař i t	RSII
stop nou t	RII
stop ova t	RII
stoup a t	RII
stoup nou t	RII
s toč en í	PRSI
s toč i t	PRII
strach ova t	RII
stran a	RI
stran ou	RS
s trav iteln ý	PRRI
s trav ová n í	PRSSI
straš i dl o	RISS
straš i t	RII
straš liv ý	RSI
straš n ý	RSI
straš n ě	RSI
s tref i t	PRII
strejd a	RI
strejč k ova t	RIII
stres	R
s trh a t	PRII
s trh nou t	PRII
s trh ova t	PRII
s trh á v a t	PRSSII
strk a t	RII
strk á n í	RSSI
s tr nou t	PRII
s tr nu t í	PRSII
stroj	R
stroj ek	RI
stroj i t	RII
strouh a n k a	RISII
strouh a t	RII
s trp ě t	PRII
strán k a	RII
strán k ova t	RIII
s tráv i t	PRII
stráž i t	RII
stráž ník	RS
stráž n ý	RSI
strýc	R
strýč ek	RI
strč i t	RII
s trž i t	PRII
stud en ý	RSI
stud i t	RII
stud i um	RIR
stud ova t	RII
s tul i t	PRII
stup eň	RI
stup n ic e	RSSI
stup ň ova t	RSII
stup ň ová n í	RSSSI
stup ň ov ý	RSSI
s tvoř en í	PRSI
s tvoř i t	PRII
s tvrd i t	PRII
s tvrz ova t	PRII
styd l iv ě	RSSI
styd nou t	RII
styl	R
styl iz ova t	RSII
s táh nou t	PRII
stár nou t	RII
stá t	RI
stát n í	RSI
stá v k ova t	RSIII
s táč e t	PRII
s téc i	PRI
stíh a t	RII
stín i t	RII
stín ova t	RII
s tísn i t	PRII
s tísn ěn ý	PRSI
stěh ova t	RII
s těsn a t	PRII
s těsn á v a t	PRSSII
střech a	RI
střed	R
střed a	RI
střed em	RI
střed isk o	RSS
střed n ě	RSI
střel ec	RI
střel ec k ý	RIII
střel i t	RII
střel n ic e	RSSI
s třep a t	PRII
s třep á v a t	PRSSII
střež i t	RII
střih a t	RII
střiž na	RS
střád a t	RII
s třás a t	PRII
s třás t	PRI
stříd a t	RII
střík a t	RII
střík nou t	RII
stříl e t	RII
such o	RS
such ý	RI
super špič k ov ý	PRISI
suš en ý	RSI
suš i t	RII
s val i t	PRII
svat ost	RS
svat ouš k ova t	RSIII
svat ý	RI
s vaz ova t	PRII
svač i t	RII
s vař i t	PRII
s vař ova t	PRII
s vlaž i t	PRII
s vléc i	PRI
s vlék a t	PRII
s vlék nou t	PRII
s vlík a t	PRII
svobod n ý	RSI
s vol a t	PRII
s vol ova t	PRII
s vol á v á n í	PRSSSSI
s voz i t	PRII
s vrh nou t	PRII
s vrh ova t	PRII
s vrh á v a t	PRSSII
s vál e t	PRII
s vá t	PRI
svát ek	RI
svát eč n í	RSSI
s váz a t	PRII
s váž e t	PRII
s véz t	PRI
s vír a t	PRII
svít a t	RII
svít i t	RII
s věs i t	PRII
svět	R
svět ec	RI
svět eln ý	RSI
svět i t	RII
svět l a t	RSII
svět l e t	RSII
svět l ý	RSI
svět él k ova t	RSIII
svět ýl k o	RSIS
s věř i t	PRII
s věř ova t	PRII
s věš ova t	PRII
syk a t	RII
syk nou t	RII
symbol	R
syn	R
syn chron iz ova t	RRSII
syn ek	RI
syn ov stv í	RSSI
syn áček	RS
syp a t	RII
system at ic k y	RSSII
system iz ova t	RSII
systém	R
syt i t	RII
syč e t	RII
syč ák	RS
sádr ova t	RII
sáh nou t	RII
sáh ova t	RII
sák nou t	RII
sál a t	RII
sá t	RI
sídl i t	RII
sídl o	RS
síl a	RI
sír a	RI
sír ov ý	RSI
síť	R
síť k ova t	RIII
síť ova t	RII
s čes a t	PRII
s čes á v a t	PRSSII
s čuch nou t	PRII
s řez a t	PRII
s řez á v a t	PRSSII
s žeh nou t	PRII
s ží v a t	PRSII
tah a t	RII
taj n ý	RSI
takt ova t	RII
tanc ova t	RII
tank ova t	RII
tat ínek	RS
tav i t	RII
taž en ý	RSI
techn ik	RS
tem ný	RS
tem n ě n ý	RSISI
ten c e	RSI
ten č i t	RSII
tep a t	RII
tes a t	RII
tesk n i t	RSII
tesk n o	RSS
tesk n ot a	RSSI
test	R
tet ičk a	RSI
tet ičč in	RSS
tet ova t	RII
text	R
text ova t	RII
tich nou t	RII
tich o	RS
tich ý	RI
tik	R
tik a t	RII
tisk	R
tisk a c í	RISI
tisk nou t	RII
titul ova t	RII
tiš e	RI
tiš i t	RII
tk a l c ova t	RISSII
tk nou t	RII
tk á t	RSI
tk á ň	RSS
tlach a t	RII
tlap a t	RII
tlap k a t	RIII
tlač en ic e	RSSI
tlač i t	RII
tlač í tk o	RIRS
tlesk nou t	RII
tloust nou t	RII
tloušt ík	RS
tlum i t	RII
tlumoč en í	RSI
tlumoč i t	RII
tlust ý	RI
tlust ě	RI
tláp nou t	RII
tm av ě t	RSII
tmel i t	RII
tm í t	RII
total iz ova t	RSII
touh a	RI
toul a t	RII
touž en í	RSI
touž i t	RII
toč i t	RII
tramp ova t	RII
tref i t	RII
tref n ě	RSI
trest	R
trest a n ec	RISI
trest a n ý	RISI
trest a t	RII
trest n ý	RSI
trh	R
trh an	RS
trh a t	RII
trk a t	RII
trk nou t	RII
tr nou t	RII
tr nu t í	RSII
troub a	RI
trous i t	RII
trp ě l iv ost	RISSS
trp ě liv ý	RISI
trp ě l iv ě	RISSI
trp ě t	RII
truhl ař i t	RSII
truhl ář sk ý	RSII
trumf nou t	RII
trv a l e	RISI
trv a nliv ost	RISS
trv a t	RII
trysk a t	RII
trysk nou t	RII
tráp en í	RSI
tráp i t	RII
tráv a	RI
tráv i t	RII
trén ink	RS
trýzeň	R
trýzn i t	RII
trž n í	RSI
tuch nou t	RII
tuh nou t	RII
tuh ost	RS
tul i t	RII
tul ák	RS
tunel ova t	RII
tup i t	RII
tup ě	RI
tup ě t	RII
tu zem sk o	PRIS
tuč n ě t	RSII
tuš en í	RSI
tuš i t	RII
tuš íc í	RSI
tuž i t	RII
tvar ova t	RII
tvor b a	RII
tvoř en í	RSI
tvoř i t	RII
tvrd i t	RII
tvrd nou t	RII
tvrd ý	RI
tvrz en í	RSI
tvář	R
typ	R
typ iz ova t	RSII
tyč	R
tyč i t	RII
tábor	R
táboř i t	RII
táh nou t	RII
tá t	RI
tát a	RI
tát ův	RI
táz a t	RII
tíseň	R
tísn i t	RII
tísn iv ý	RSI
tíž	R
tíž i t	RII
týr á n í	RSSI
těk a t	RII
těl es o	RSS
těl n at ě t	RSSII
těl o	RS
těsn a t	RII
těsn ý	RI
těš en í	RSI
těš i t	RII
těž c e	RSI
těž i t	RII
těž k o	RIS
těž k ý	RII
třep i t	RII
třep ot a t	RSII
třes ou c í	RSSI
třešt i t	RII
třás t	RI
tříd a	RI
tříd i t	RII
tříd i čk a	RIRI
třísk a t	RII
třísk nou t	RII
u bal i t	PRII
u bedn i t	PRII
u bliž ova t	PRII
u bod a t	PRII
u brous i t	PRII
u brzd i t	PRII
u brán i t	PRII
u by t ová n í	PRISSI
u bý t	PRI
u bý v a t	PRSII
u běh a t	PRII
u ced i t	PRII
u checht a t	PRII
u checht á v a t	PRSSII
u chod i t	PPII
u chop i t	PRII
u chov a t	PRII
u chov á n í	PRSSI
u chov á v a t	PRSSII
u chrán i t	PRII
u chyl ova t	PRII
u chyst a t	PRII
u chyt i t	PRII
u chyt nou t	PRII
u chýl i t	PRII
u cour a t	PRII
u couv nou t	PRII
u cp á v a t	PRSSII
u ct i v ě	PRISI
u ct í t	PRII
u ct í v á n í	PRISSSI
u cuc á v a t	PRSSII
u cuk nou t	PRII
u cuk á v a t	PRSSII
u cít i t	PRII
ud i t	RII
u drob i t	PRII
u drol i t	PRII
u drž e n í	PRISI
u drž i teln ý	PRISI
u drž ova n ý	PRISI
u drž ova t	PRII
u dup a t	PRII
u dup á v a t	PRSSII
u dus i t	PRII
u dus á v a t	PRSSII
u dáv i t	PRII
u díl e t	PRII
u dých a n ý	PRISI
u dých a t	PRII
u děl a t	PRII
u děl i t	PRII
u děl á n í	PRSSI
u dř í t	PRII
u fik nou t	PRII
u fouk nou t	PRII
u has i t	PRII
u has ín a t	PRSII
uhel n at ě t	RSSII
u hlaz ova t	PRII
u hled a t	PRII
u hlod a t	PRII
uhl í	RI
u hlíd a t	PRII
u hmat a t	PRII
u hnizď ova t	PRII
u hní t	PRI
u hní v a t	PRSII
u hnízd i t	PRII
u hobl ova t	PRII
u hod i t	PRII
u host i t	PRII
u hoz en ost	PRSS
u hoz en ý	PRSI
u hrab a t	PRII
u hrab á v a t	PRSSII
u hrad i t	PRII
u hraz ova t	PRII
u hryz a t	PRII
u hryz nou t	PRII
u hryz á v a t	PRSSII
u hrá t	PRI
u háj i t	PRII
u háč k ova t	PRIII
u hýb a t	PRII
u jas n i t	PRSII
u jas ň ova t	PRSII
u jedn á v a t	PRSSII
u je t	PRI
u jezd i t	PRII
u jišť ova t	PRII
u jíd a t	PRII
u jím a t	PRII
u jí t	PRI
u jížd ě t	PRII
u kamen ová v a t	PRSSII
u kap á v a t	PRSSII
u kaz ova t	PRII
u kec a t	PRII
u klid i t	PRII
u klid n i t	PRSII
u klid ň ova t	PRSII
u klid ň uj íc í	PRSSSI
u klon i t	PRII
u klov nou t	PRII
u klán ě t	PRII
u klíz e t	PRII
u koj i t	PRII
u koj ova t	PRII
u koléb a t	PRII
u konejš i t	PRII
u konejš ova t	PRII
u konč i t	PRII
u konč ova t	PRII
u kop a t	PRII
u kop nou t	PRII
u kous a t	PRII
u kous nou t	PRII
u kous nu t í	PRSII
u kořist i t	PRII
u krad en í	PRSI
u krad en ý	PRSI
u krot i t	PRII
u krout i t	PRII
u krád a t	PRII
u kráj e t	PRII
u krás t	PRI
u krý t	PRI
u krý v a t	PRSII
u kus ova t	PRII
u kut i t	PRII
u kvap en ý	PRSI
u kvap i t	PRII
u kvap ova t	PRII
u káj e t	PRII
u káp nou t	PRII
u káz a t	PRII
u křič e t	PRII
u křiž ova t	PRII
u lek nou t	PRII
u let ova t	PRII
u let ě t	PRII
ulic e	RI
u liz ova t	PRII
ulič n ík	RSS
u loup en í	PRSI
u loup nou t	PRII
u lož en í	PRSI
u lož i t	PRII
u lám a t	PRII
u lét a t	PRII
u lét á v a t	PRSSII
u lé v a t	PRSII
u líb a t	PRII
u lí t	PRI
u lít á v a t	PRSSII
u líz a t	PRII
u líz nou t	PRII
u maz a t	PRII
u mačk a t	PRII
u mdl é v a t	PRISII
u mdl í t	PRII
u mdl í v a t	PRISII
u met á v a t	PRSSII
u mix ova t	PRII
u miň ova t	PRII
u mlouv a t	PRII
u mluv i t	PRII
u ml í t	PRII
u mlč e t	PRII
u mlč ova t	PRII
u moc n i t	PRSII
u moc ň ova t	PRSII
u modř i t	PRII
u mok nou t	PRII
u mot a t	PRII
u mot á v a t	PRSSII
u moř i t	PRII
u moř ova t	PRII
u mrav n i t	PRSII
u mrav ň ova t	PRSII
u mrtv i t	PRII
u mrtv ova t	PRII
u muč i t	PRII
u máz nou t	PRII
u máč e t	PRII
u mích a t	PRII
u mín i t	PRII
u mír a t	PRII
u míst i t	PRII
u mý t	PRI
u mý v a t	PRSII
um ě l e	RISI
um ě l k ova t	RISIII
um ě n í	RISI
um ě t	RII
u nož i t	PRII
u nud i t	PRII
u náš e t	PRII
u pad a t	PRII
u pad á v a t	PRSSII
u pal ova t	PRII
u pamat ova t	PRII
u pamat ová v a t	PRSSII
u patl a t	PRII
u paž i t	PRII
u paž ova t	PRII
u pevn i t	PRII
u pevn ěn í	PRSI
u pil ova t	PRII
u pis ova t	PRII
u pis ova tel	PRIS
u plak a t	PRII
u plav a t	PRII
u pliv a t	PRII
u pliv nou t	PRII
u pliv ova t	PRII
u pliv á v a t	PRSSII
u ply nou t	PRII
u plác a t	PRII
u plác e t	PRII
u plác á v a t	PRSSII
u plét a t	PRII
u plý v a t	PRSII
u pot i t	PRII
u po třeb i t	PPRII
u pout a t	PRII
u pout á v a t	PRSSII
u poušt ě t	PRII
u po zor n i t	PPRSII
u po zor ň ova t	PPRSII
u prac ova t	PRII
u prav en ý	PRSI
u prav i t	PRII
u prav ova t	PRII
u praž en í	PRSI
u prch nou t	PRII
u proš ova t	PRII
u práš i t	PRII
u ps a t	PRII
u pust i t	PRII
u pál i t	PRII
u péc i	PRI
u pích nou t	PRII
u pín a č	PRIS
u pěch ova t	PRII
u přesn i t	PRII
u přesň ova t	PRII
u přím n ost	PRSS
u přís t	PRI
u rad i t	PRII
u rob i t	PRII
u rod i t	PRII
u rv a t	PRII
u rychl i t	PRII
u rychl ova t	PRII
u rychl ová n í	PRSSI
u ráž k a	PRII
u rýp nou t	PRII
u rý t	PRI
u sch nou t	PRII
u s chov a t	PPRII
u s chov á v a t	PPRSSII
u sek a t	PRII
u sek nou t	PRII
u sek á v a t	PRSSII
u sidl ova t	PRII
u s jedn ot i t	PPRSII
u skuteč n i t	PRSII
u skuteč n ěn í	PRSSI
u skuteč ň ova t	PRSII
u skuteč ň ová n í	PRSSSI
u skříp l e	PRSI
u slin i t	PRII
u smaž i t	PRII
u s mlouv a t	PPRII
u s mr c ova t	PPRSII
u s mr c uj íc í	PPRSSSI
u s mr t i t	PPRIII
u s mysl e t	PPRII
u smí v a t	PRSII
u s náš e t	PPRII
u s nés t	PPRI
u soud i t	PRII
u s plav n i t	PPRSII
u s plav ň ova t	PPRSII
u spoř i t	PRII
u sp á v a t	PRSSII
u spě t	PRI
u srk nou t	PRII
u srk á v a t	PRSSII
u star a t	PRII
u sta t	PRI
u stl a t	PRII
u stoup i t	PRII
u straš i t	PRII
u s tr nu l e	PPRSSI
u stroj i t	PRII
u strouh a t	PRII
u stup ova t	PRII
u stá n í	PRSI
u stá t	PRI
u střel i t	PRII
u střád a t	PRII
u suš i t	PRII
u sych a t	PRII
u syp a t	PRII
u syp á v a t	PRSSII
u sídl i t	PRII
u sín a t	PRII
u sýp a t	PRII
u tah a t	PRII
u tah ova t	PRII
u taj ova t	PRII
u tanc ova t	PRII
u tanč i t	PRII
u tisk ova t	PRII
u tiš i t	PRII
u tiš ova t	PRII
u tk a t	PRII
u tk á v a t	PRSSII
u tlač ova t	PRII
u tlouc i	PRI
u tlouk a t	PRII
u tlum i t	PRII
u trh a t	PRII
u trh nou t	PRII
u trh ova t	PRII
u trous i t	PRII
u trp e n í	PRISI
u trp ě t	PRII
u trác e t	PRII
u tráp i t	PRII
u trýzn i t	PRII
u trž i t	PRII
u tuch nou t	PRII
u tuh nou t	PRII
u tuž i t	PRII
u tvoř i t	PRII
u tvrd nou t	PRII
u tvrz ova t	PRII
u tvář en í	PRSI
u táboř i t	PRII
u táh nou t	PRII
u téc i	PRI
u tík a t	PRII
u tír a t	PRII
u týr a t	PRII
u těsň ova t	PRII
u těš en ý	PRSI
u těš i t	PRII
u těš ova t	PRII
u těš uj íc í	PRSSI
u tř í t	PRII
u vad nou t	PRII
u val i t	PRII
u val ova t	PRII
u var ova t	PRII
u vaz ova t	PRII
u vař i t	PRII
u veleb i t	PRII
u veleb ova t	PRII
u vol i t	PRII
u vol n i t	PRSII
u vol n ěn í	PRSSI
u vol ova t	PRII
u vol ň ova t	PRSII
u vrh nou t	PRII
u vrh ova t	PRII
u vrt a t	PRII
u vál e t	PRII
u váz a t	PRII
u váz nou t	PRII
u véz t	PRI
u víj e t	PRII
u ví t	PRI
u vít a t	PRII
u vít á n í	PRSSI
u víz nou t	PRII
u věz n i t	PRSII
u věř i t	PRII
u za mk nou t	PPRII
u za vír a t	PPRII
u za vř e n í	PPRISI
u zdrav en í	PRSI
u zdrav i t	PRII
u zdrav ova t	PRII
u zdvih nou t	PRII
uz en ý	RSI
u zl ob i t	PRSII
u znam en a t	PRSII
u zn á n í	PRSSI
u zn á v á n í	PRSSSSI
u zouf a t	PRII
u zrá t	PRI
u zrá v a t	PRSII
uč eb n ic e	RSSSI
uč en ec	RSI
uč en í	RSI
u čes a t	PRII
u čin i t	PRII
u čin ěn ý	PRSI
uč i tel ova t	RISII
u člen i t	PRII
u čoud i t	PRII
u řeht a t	PRII
u řek nou t	PRII
u řez á v a t	PRSSII
u říd i t	PRII
u řít i t	PRII
u říz nou t	PRII
u škod i t	PRII
u škrt i t	PRII
u škub nou t	PRII
u škvař i t	PRII
u šlap ova t	PRII
u šlap á v a t	PRSSII
u šlecht i l ost	PRISS
u šleh a t	PRII
u šláp nou t	PRII
u š l ý	PPPI
u šmudl a t	PRII
u šoup a t	PRII
u špin i t	PRII
u šplích nou t	PRII
u štv a t	PRII
u štíp nou t	PRII
u štíp á v a t	PRSSII
u štěk a t	PRII
u ší t	PRI
u žmol i t	PRII
u žvýk a t	PRII
vad i t	RII
valch ova t	RII
val n ý	RSI
vandr ova t	RII
vandr ov n í	RSSI
vandr ák	RS
va nou t	RII
varhan y	RI
var ova t	RII
vař i t	RII
v cház e t	PPII
v ciť ova t	PRII
v cuc nu t í	PRSII
v cít i t	PRII
v dech nou t	PRII
v dech ova t	PRII
ve jí t	PRI
veleb i t	RII
vel e t	RII
ve mlouv a t	PRII
ve mluv i t	PRII
ven k ov an	RISS
ven k u	RIS
ven č i t	RSII
verb ova t	RII
ves	R
vesel e	RI
vesel ost	RS
vesel ý	RI
vesl ař	RS
vesl ova t	RII
ves nic e	RSI
ve tk nou t	PRII
ve tř í t	PRII
ve val i t	PRII
ve zd í t	PRII
večeř e t	RII
v haz ova t	PRII
v hod i t	PRII
v hop k a t	PRIII
v hrk nou t	PRII
v hr nou t	PRII
vibr ova t	RII
vid iteln ý	RRI
vid ova t	RII
vid ě n í	RISI
vikl a t	RII
vin i t	RII
vis e t	RII
viz ova t	RII
v je t	PRI
v jížd ě t	PRII
v kap a t	PRII
v klouz a t	PRII
v klouz nou t	PRII
v klouz á v a t	PRSSII
v klád a t	PRII
v kop nou t	PRII
v koul e t	PRII
v kořen i t	PRII
v krád a t	PRII
vlad ař i t	RSII
vlas	R
vlast	R
vlast n i t	RSII
vlast n í	RSI
vlast n ě	RSI
v let ě t	PRII
vlh c e	RSI
vlh k o	RIS
vlh č i t	RSII
v lichoc ova t	PRII
v lichot i t	PRII
v lis ova t	PRII
vlk	R
vln a	RI
vln i t	RII
v loud i t	PRII
v loud ěn í	PRSI
v loup a t	PRII
v lož i t	PRII
v lož k a	PRII
v lož k ova c í	PRIISI
vlád nou t	RII
v lák a t	PRII
vlás ek	RI
vlá t	RI
vláč n ý	RSI
vléc i	RI
v lét a t	PRII
v lét á v a t	PRSSII
v lé v a t	PRSII
v léz a t	PRII
v léz t	PRI
v lí t	PRI
v lít a t	PRII
vlč ek	RI
v mačk a t	PRII
v mont ova t	PRII
v mysl e t	PRII
v mích a t	PRII
v mýšl e t	PRII
v noř i t	PRII
v nuc ova t	PRII
v nut i t	PRII
v náš e t	PRII
v nés t	PRI
v ním a t	PRII
v ním a teln ý	PRISI
v ním a tel sk ý	PRISII
v ním á n í	PRSSI
vod a	RI
vod n at ě t	RSSII
vod nés t	RRI
vod ní	RS
vod n ík	RSS
vol a t	RII
vol i t	RII
vol n ost	RSS
vol n í	RSI
vol n ý	RSI
vol n ě	RSI
vol á n í	RSSI
voz i t	RII
voz ovk a	RSI
v pad a t	PRII
v pad á v a t	PRSSII
v pal ova t	PRII
v paš ova t	PRII
v pich ova t	PRII
v plat i t	PRII
v plíž i t	PRII
v poušt ě t	PRII
v prav i t	PRII
v pump ova t	PRII
v pust i t	PRII
v pál i t	PRII
v páč i t	PRII
v pích a t	PRII
v pích nou t	PRII
v pích á v a t	PRSSII
vrac e n í	RISI
vrac e t	RII
v raz i t	PRII
vrch n í	RSI
vrch ol i t	RSII
vrh a t	RII
vrk a t	RII
v roub i t	PRII
v roub k ova t	PRIII
vrstv a	RI
vrstv i t	RII
vrt a t	RII
vrt nou t	RII
vrt á n í	RSSI
vrt ě t	RII
v rub ova t	PRII
vrz nou t	RII
vrás k a	RII
vrát i t	RII
vrávor a t	RII
v ráž e n í	PRISI
v ráž e t	PRII
v rýp nou t	PRII
v rý t	PRI
v rý v a t	PRSII
vrč e t	RII
vrš ek	RI
v růst a t	PRII
vrž en ý	RSI
v skoč i t	PRII
v sol i t	PRII
v srk nou t	PRII
v strč i t	PRII
v stup ova t	PRII
v stá t	PRI
v stá v a t	PRSII
v střel i t	PRII
v střik ova t	PRII
v střík nou t	PRII
v syp a t	PRII
v syp á v a t	PRSSII
v sá t	PRI
v sá v a t	PRSII
v sít i t	PRII
v tah ova t	PRII
v tes a t	PRII
vtip k ova t	RIII
v tisk a t	PRII
v tisk nou t	PRII
v tisk á v a t	PRSSII
v tlač i t	PRII
v tlač ova t	PRII
v tlouc i	PRI
v trh ova t	PRII
v trž en ý	PRSI
v táh nou t	PRII
v téc i	PRI
v ték a t	PRII
v těl i t	PRII
v těl ova t	PRII
v těsn a t	PRII
v těsn á v a t	PRSSII
vulkan iz ova t	RSII
vy babr a t	PRII
vy baf a t	PRII
vy bagr ova t	PRII
vy bal i t	PRII
vy bal ova t	PRII
vy barv ova t	PRII
vy bav en í	PRSI
vy bav en ý	PRSI
vy bav ova t	PRII
vy bedn i t	PRII
vy belh a t	PRII
vy beton ova t	PRII
vy blejsk nou t	PRII
vy blázn i t	PRII
vy blí t	PRI
vy blýsk a t	PRII
vy bod ova t	PRII
vy boj ova t	PRII
vy boj ová v a t	PRSSII
vy bouch nou t	PRII
vy bour a t	PRII
vy bouř i t	PRII
vy boč i t	PRII
vy boč ova t	PRII
vy brod i t	PRII
vy brous i t	PRII
vy bruš ova t	PRII
vy brynd a t	PRII
vy bubn ova t	PRII
vy buch ova t	PRII
vy bud ova t	PRII
vy buj e t	PRII
vy bád a t	PRII
vy básn i t	PRII
vy bíl i t	PRII
vy bý t	PRI
vy bý v a t	PRSII
vy běh a t	PRII
vy běh á v a t	PRSSII
vy běl e t	PRII
vy běl i t	PRII
vy ced i t	PRII
vy cement ova t	PRII
vy cen i t	PRII
vy ceň ova t	PRII
vy chcíp a t	PRII
vy chlad i t	PRII
vy chlad nou t	PRII
vy chlast a t	PRII
vy chlaz ova t	PRII
vy chov a t	PRII
vy chov á v a c í	PRSSISI
vy chov á v a t	PRSSII
vy chrchl a t	PRII
vy chrchl á v a t	PRSSII
vy chut n á v a t	PRSSSII
vy chval ova t	PRII
vy chvál i t	PRII
vy chvě t	PRI
vy chyl ova t	PRII
vy chyt a t	PRII
vy chytr ač i t	PRSII
vy chyt á v a t	PRSSII
vy cház ej íc í	PPRSI
vy cház e t	PPII
vy chýl i t	PRII
vy cink a t	PRII
vy ciť ova t	PRII
vy cl í v a t	PRISII
vy cp a t	PRII
vy cuc a t	PRII
vy cuc á v a t	PRSSII
vy cvič i t	PRII
vy cvál a t	PRII
vy cák nou t	PRII
vy cít i t	PRII
vy dař i t	PRII
vy dech ova t	PRII
vy dekor ova t	PRII
vy dlab an ý	PRSI
vy dlab a t	PRII
vy dlab á v a t	PRSSII
vy dloub a t	PRII
vy dloub nou t	PRII
vy dloub á v a t	PRSSII
vy dluž i t	PRII
vy dlážd i t	PRII
vy dm ou t	PRSI
vy do bý t	PPRI
vy do bý v a t	PPRSII
vy doj ova t	PRII
vy dol ova t	PRII
vy dou t	PRI
vy dou v a t	PRSII
vy dražď ova t	PRII
vy drb a t	PRII
vy drh nou t	PRII
vy drob i t	PRII
vy drol i t	PRII
vy drol ova t	PRII
vy dráp a t	PRII
vy dráp nou t	PRII
vy drát k ova t	PRIII
vy dráž k ova t	PRIII
vy drž e t	PRII
vy drž ova t	PRII
vy dum a t	PRII
vy dup a t	PRII
vy dup á v a t	PRSSII
vy dáv i t	PRII
vy dír a t	PRII
vy dých a t	PRII
vy děd i t	PRII
vy děl ova t	PRII
vy děl á v a t	PRSSII
vy děr a č n ost	PRISSS
vy děr ova t	PRII
vy děs i t	PRII
vy dř í t	PRII
vy fint i t	PRII
vy flák nou t	PRII
vy fot i t	PRII
vy fouk á v a t	PRSSII
vy fuk ova t	PRII
vy fár a t	PRII
vy has i t	PRII
vy has nou t	PRII
vy has ín a t	PRSII
vy hek nou t	PRII
vy hlad i t	PRII
vy hlad ov ova t	PRSII
vy hlad ov ě t	PRSII
vy hlaz ova t	PRII
vy hlaš ova t	PRII
vy hled á v a t	PRSSII
vy hled ě t	PRII
vy hlod a t	PRII
vy hlod á v a t	PRSSII
vy hloub a t	PRII
vy hloub i t	PRII
vy hlub ova t	PRII
vy hlás i t	PRII
vy hláš en í	PRSI
vy hlíd a t	PRII
vy hmát nou t	PRII
vy hn a t	PRII
vy hnoj i t	PRII
vy hnís t	PRI
vy hní t	PRI
vy hní v a t	PRSII
vy hobl ova t	PRII
vy hoj i t	PRII
vy hol i t	PRII
vy hop k a t	PRIII
vy hop k ova t	PRIII
vy host i t	PRII
vy hotov i t	PRII
vy hotov ova t	PRII
vy hošť ova t	PRII
vy hrad i t	PRII
vy hraz ova t	PRII
vy hrk nou t	PRII
vy hr nou t	PRII
vy hroc ova t	PRII
vy hrot i t	PRII
vy hrož ova t	PRII
vy hryz a t	PRII
vy hryz nou t	PRII
vy hráb nou t	PRII
vy hrá t	PRI
vy hrá v a t	PRSII
vy hub i t	PRII
vy hub nou t	PRII
vy hák ova t	PRII
vy hán ě t	PRII
vy ház e t	PRII
vy háč k ova t	PRIII
vy hýb a t	PRII
vy hýb a v ě	PRISI
vy hřá t	PRI
vy hří v a t	PRSII
vy jas n i t	PRSII
vy jas n ěn ý	PRSSI
vy jas ň ova t	PRSII
vy jedn a t	PRII
vy jedn ot i t	PRSII
vy jedn á v á n í	PRSSSSI
vy je t	PRI
vy jev i t	PRII
vy jezd i t	PRII
vy jíd a t	PRII
vy jím a t	PRII
vy jížd ě t	PRII
vy kachl ík ova t	PRSII
vy kal i t	PRII
vy kap a t	PRII
vy kap á v a t	PRSSII
vy kartáč ova t	PRII
vy kas a t	PRII
vy kaz ova t	PRII
vy kašl a t	PRII
vy kašl á v a t	PRSSII
vy kec a t	PRII
vy klep a t	PRII
vy klep nou t	PRII
vy klep á v a t	PRSSII
vy klest i t	PRII
vy klesť ova t	PRII
vy klešť ova t	PRII
vy klid i t	PRII
vy kliz ova t	PRII
vy klič k ova t	PRIII
vy klon i t	PRII
vy klop i t	PRII
vy klop ova t	PRII
vy klopýt a t	PRII
vy kloub i t	PRII
vy klouz a t	PRII
vy klouz nou t	PRII
vy klouz á v a t	PRSSII
vy klov a t	PRII
vy klub a t	PRII
vy klán ě t	PRII
vy kláp ě t	PRII
vy klíz e t	PRII
vy klíč i t	PRII
vy kokt a t	PRII
vy koled ova t	PRII
vy kolíb a t	PRII
vy kol ík ova t	PRSII
vy kol íč k ova t	PRSIII
vy kombin ova t	PRII
vy kon a t	PRII
vy kon á v a t	PRSSII
vy kon á v á n í	PRSSSSI
vy kop a t	PRII
vy kop nou t	PRII
vy kop á v a t	PRSSII
vy kost i t	PRII
vy kosť ova t	PRII
vy kouk a t	PRII
vy kouk nou t	PRII
vy koup a t	PRII
vy koup en í	PRSI
vy koup i t	PRII
vy kous nou t	PRII
vy kouzl i t	PRII
vy kouř i t	PRII
vy kořen i t	PRII
vy kořist i t	PRII
vy kořisť ova t	PRII
vy kraj ova t	PRII
vy kraš l ova t	PRSII
vy krm i t	PRII
vy krm ova t	PRII
vy kroj i t	PRII
vy kroj ova t	PRII
vy krout i t	PRII
vy kruž ova t	PRII
vy krv ác e t	PRSII
vy krystal iz ova t	PRSII
vy kráj e t	PRII
vy kráš l i t	PRSII
vy krý t	PRI
vy krý v a t	PRSII
vy kuch a t	PRII
vy kuk ova t	PRII
vy kus ova t	PRII
vy kut a t	PRII
vy kutál en ý	PRSI
vy kutál e t	PRII
vy kut á v a t	PRSSII
vy kuř ova t	PRII
vy kvas i t	PRII
vy kvét a t	PRII
vy kyd a t	PRII
vy kyp ě t	PRII
vy kác e t	PRII
vy kál e t	PRII
vy káz a t	PRII
vy křik nou t	PRII
vy křik ova t	PRII
vy lad i t	PRII
vy lam ova t	PRII
vy laď ova t	PRII
vy lek a t	PRII
vy let ě t	PRII
vy lešt i t	PRII
vy lh a t	PRII
vy lis ova t	PRII
vy liz ova t	PRII
vy lič ova t	PRII
vy loud a t	PRII
vy loud i t	PRII
vy loup a t	PRII
vy loup i t	PRII
vy loup nou t	PRII
vy loup nu t ý	PRSII
vy loup á v a t	PRSSII
vy lousk a t	PRII
vy lousk nou t	PRII
vy louč en í	PRSI
vy louž i t	PRII
vy lov i t	PRII
vy lož i t	PRII
vy lup ova t	PRII
vy luz ova t	PRII
vy luč ova t	PRII
vy lušt i t	PRII
vy lák a t	PRII
vy lám a t	PRII
vy lét a t	PRII
vy lét á v a t	PRSSII
vy lé v a t	PRSII
vy léč i t	PRII
vy lín a t	PRII
vy lí t	PRI
vy lít a t	PRII
vy lít nou t	PRII
vy lít á v a t	PRSSII
vy lí v a t	PRSII
vy líz a t	PRII
vy líz nou t	PRII
vy líz á v a t	PRSSII
vy líč i t	PRII
vy mal ova t	PRII
vy manévr ova t	PRII
vy mast i t	PRII
vy mas ír ova t	PRSII
vy maz a t	PRII
vy mačk a t	PRII
vy met a t	PRII
vy mez n ík ova t	PRSSII
vy miz e t	PRII
vy miň ova t	PRII
vy mk nou t	PRII
vy mluv i t	PRII
vy mlát i t	PRII
vy ml í t	PRII
vy moc i	PRI
vy model ova t	PRII
vy modl i t	PRII
vy mont ova t	PRII
vy mot a t	PRII
vy mot á v a t	PRSSII
vy moř i t	PRII
vy mrsk a t	PRII
vy mrsk nou t	PRII
vy mršt i t	PRII
vy myc ova t	PRII
vy myk a t	PRII
vy mysl e t	PRII
vy mysl i t	PRII
vy máh a t	PRII
vy máh á n í	PRSSI
vy mám i t	PRII
vy máz nou t	PRII
vy máč e t	PRII
vy mín i t	PRII
vy mý t	PRI
vy mýt a t	PRII
vy mýt i t	PRII
vy mýšl e t	PRII
vy měn i t	PRII
vy měň ova t	PRII
vy měř i t	PRII
vy mř í t	PRII
vy na chvál i t	PPRII
vy na hrad i t	PPRII
vy na hraz ova t	PPRII
vy na léz a t	PPRII
vy na léz t	PPRI
vy na léz á n í	PPRSSI
vy nech a t	PRII
vy nech á v a t	PRSSII
vy noř i t	PRII
vy noř ova t	PRII
vy nuc en ý	PRSI
vy nuc ova t	PRII
vy ná lez c ův	PPRSI
vy náš e n í	PRISI
vy náš e t	PRII
vy nés t	PRI
vy obc ova t	PRII
vy oper ova t	PRII
vy ostř i t	PRII
vy ostř ova t	PRII
vy pad nou t	PRII
vy pad á v a t	PRSSII
vy pancéř ova t	PRII
vy parád i t	PRII
vy pař i t	PRII
vy pař ova t	PRII
vy pich ova t	PRII
vy pil ova n ě	PRISI
vy pil ova t	PRII
vy pipl a t	PRII
vy pis ova t	PRII
vy pj at ý	PRSI
vy plak a t	PRII
vy plat i t	PRII
vy plav ová n í	PRSSI
vy plaz i t	PRII
vy plaz ova t	PRII
vy plaš i t	PRII
vy plen i t	PRII
vy pliv a t	PRII
vy pliv nou t	PRII
vy pliv á v a t	PRSSII
vy pln i t	PRII
vy pln ěn í	PRSI
vy pln ěn ý	PRSI
vy ply nou t	PRII
vy plác e t	PRII
vy plét a t	PRII
vy plí t	PRI
vy plíž i t	PRII
vy plýtv a t	PRII
vy plň ová n í	PRSSI
vy plň uj íc í	PRSSI
vy po klon k ova t	PPRIII
vy po máh a t	PPRII
vy portrét ova t	PRII
vy po třeb ova t	PPRII
vy poušt ě t	PRII
vy po víd a t	PPRII
vy po věd ě t	PPRII
vy po zor ova t	PPRII
vy po řád a t	PPRII
vy prac ova t	PRII
vy prac ová n í	PRSSI
vy prac ová v a t	PRSSII
vy pr a t	PRII
vy prav i t	PRII
vy prav ova t	PRII
vy prav ová n í	PRSSI
vy praž i t	PRII
vy prch a t	PRII
vy proš ova t	PRII
vy prsk nou t	PRII
vy pruž i t	PRII
vy prásk a t	PRII
vy práv ě t	PRII
vy práš i t	PRII
vy prš e t	PRII
vy ps a t	PRII
vy pt a t	PRII
vy pud i t	PRII
vy pump ova t	PRII
vy pust i t	PRII
vy puz ova t	PRII
vy puč e t	PRII
vy pušt ěn ý	PRSI
vy pál i t	PRII
vy pár a t	PRII
vy pás t	PRI
vy pátr a t	PRII
vy páč i t	PRII
vy péc i	PRI
vy pér ova t	PRII
vy pích a t	PRII
vy pích nou t	PRII
vy pích á v a t	PRSSII
vy pík a t	PRII
vy pín a t	PRII
vy pín ač	PRS
vy pír a t	PRII
vy písk a t	PRII
vy písk nou t	PRII
vy pěst i t	PRII
vy pěst ova t	PRII
vy půjč i t	PRII
vy půjč ova t	PRII
vy rab ova t	PRII
vy raz i t	PRII
vy rob i t	PRII
vy roj i t	PRII
vy rub a t	PRII
vy ruš i t	PRII
vy ruš ova t	PRII
vy rv a t	PRII
vy ráb ě t	PRII
vy ráž e t	PRII
vy rýp a t	PRII
vy rýp nou t	PRII
vy rý t	PRI
vy rý v a t	PRSII
vy sch nou t	PRII
vy sed ě t	PRII
vy sek a t	PRII
vy sek nou t	PRII
vy sidl ova t	PRII
vy sil ova t	PRII
vy skak ova t	PRII
vy skoč i t	PRII
vy skák a t	PRII
vy sl a n ý	PRISI
vy sl a t	PRII
vy sled ova t	PRII
vy slouž i l ý	PRISI
vy slouž i t	PRII
vy slyš e t	PRII
vy sl á n í	PRSSI
vy slíd i t	PRII
vy smaž i t	PRII
vy smaž ova t	PRII
vy smol i t	PRII
vy smrk a t	PRII
vy smí v a t	PRSII
vys ok o	RIS
vys ok ý	RII
vy sol i t	PRII
vy sol ova t	PRII
vy sond ova t	PRII
vy soud i t	PRII
vy souk a t	PRII
vy souš e t	PRII
vy sp a t	PRII
vy spekul ova t	PRII
vy s prav i t	PPRII
vy spár ova t	PRII
vy sp á v a t	PRSSII
vy spě l ý	PRSI
vy sr a t	PRII
vy srk nou t	PRII
vy s ráž e t	PPRII
vy sta v en ý	PRSSI
vy stač i t	PRII
vy stih nou t	PRII
vy stih ova t	PRII
vy stl a t	PRII
vy ston a t	PRII
vy stop ova t	PRII
vy straš i t	PRII
vy stres ova t	PRII
vy strk ova t	PRII
vy strk á v a t	PRSSII
vy stroj en ý	PRSI
vy stroj i t	PRII
vy strč i t	PRII
vy stud ova t	PRII
vy stup ova t	PRII
vy stup ň ova t	PRSII
vy stěh ova t	PRII
vy stěh ová v a t	PRSSII
vy střel i t	PRII
vy střel ova t	PRII
vy stříd a t	PRII
vy stříd á v a t	PRSSII
vy střík a t	PRII
vy střík nou t	PRII
vy stříl e t	PRII
vy suš i t	PRII
vy suš ova t	PRII
vy s vléc i	PPRI
vy s vlék a t	PPRII
vy s vlék nou t	PPRII
vy s vlík a t	PPRII
vy svobod i t	PRII
vy svoboz ova t	PRII
vy svít i t	PRII
vy svěc ova t	PRII
vy svět i t	PRII
vy syp a t	PRII
vy syp á v a t	PRSSII
vy sá t	PRI
vy sá v a t	PRSII
vy sídl i t	PRII
vy sídl uj íc í	PRSSI
vy síl a t	PRII
vy síl i t	PRII
vy síl á n í	PRSSI
vy síř i t	PRII
vy sýp a t	PRII
vy tah a t	PRII
vy tah ova t	PRII
vy tanc ova t	PRII
vy tanč i t	PRII
vy tep a t	PRII
vy tes a t	PRII
vy tes á v a t	PRSSII
vy tisk nou t	PRII
vy tišt ěn í	PRSI
vy tk nou t	PRII
vy tlach a t	PRII
vy tlač i t	PRII
vy tlač ova t	PRII
vy tlouc i	PRI
vy tlouk a t	PRII
vy tm av i t	PRSII
vy tmel i t	PRII
vy t nou t	PIII
vy touž en ý	PRSI
vy toč i t	PRII
vy trac en ý	PRSI
vy trest a t	PRII
vy trh a t	PRII
vy trh nou t	PRII
vy trh ova t	PRII
vy trh á v a t	PRSSII
vy troub i t	PRII
vy trp ě t	PRII
vy trv a l e	PRISI
vy trv á v a t	PRSSII
vy trysk nou t	PRII
vy trysk ova t	PRII
vy trác e t	PRII
vy tráv i t	PRII
vy trž en í	PRSI
vy tuš i t	PRII
vy tvar ova t	PRII
vy tvář e t	PRII
vy táh nou t	PRII
vy táč e t	PRII
vy ték a t	PRII
vy tír a t	PRII
vy tíž i t	PRII
vy týk a t	PRII
vy těž i t	PRII
vy třep a t	PRII
vy třep á v a t	PRSSII
vy třešt i t	PRII
vy třešt ěn ý	PRSI
vy třás a t	PRII
vy třás t	PRI
vy tříb i t	PRII
vy tříd i t	PRII
vy třísk a t	PRII
vy tř í t	PRII
vy um ě l k ova t	PRISIII
vy uč i t	PRII
vy uč ova t	PRII
vy uč ová n í	PRSSI
vy uč uj íc í	PRSSI
vy u ží v a t	PPRSII
vy val i t	PRII
vy val ova t	PRII
vy var ova t	PRII
vy vaz ova t	PRII
vy vař i t	PRII
vy vař ova t	PRII
vy ven č i t	PRSII
vy vlast ň ova t	PRSII
vy vléc i	PRI
vy vlík a t	PRII
vy vol a t	PRII
vy vol i t	PRII
vy vol á v a t	PRSSII
vy vrac e t	PRII
vy vrch ol i t	PRSII
vy vrh a t	PRII
vy vrh e l	PRIS
vy vrh nou t	PRII
vy vrt a t	PRII
vy vrt nou t	PRII
vy vrt á v a t	PRSSII
vy vrt ě t	PRII
vy vrz a t	PRII
vy vrát i t	PRII
vy vrávor a t	PRII
vy v stá v a t	PPRSII
vy vz tek a t	PPRII
vy vál e t	PRII
vy vá t	PRI
vy váz a t	PRII
vy váz nou t	PRII
vy váž e c í	PRISI
vy váž en ě	PRSI
vy větr a t	PRII
vy větr á n í	PRSSI
vy větř i t	PRII
vy věš ova t	PRII
vy vřísk nou t	PRII
vy zař ova t	PRII
vy zdvih ova t	PRII
vy zdvih á v a t	PRSSII
vy zd í v a t	PRISII
vy z koum a t	PPRII
vy z kouš e t	PPRII
vy z kus i t	PPRII
vy znam en á v a t	PRSSSII
vy zn a t	PRII
vy znač i t	PRII
vy znač ova t	PRII
vy zn á v a t	PRSSII
vy zn í t	PRII
vy zn í v a t	PRISII
vy zob a t	PRII
vy zou t	PRI
vy zou v a t	PRSII
vy z po víd a t	PPPRII
vy z pyt ova t	PPRII
vy z pě v ova t	PPRSII
vy z rad i t	PPRII
vy z raz ova t	PPRII
vy zrá t	PRI
vy zrá v a t	PRSII
vy z tuž i t	PPRII
vy z tuž ova t	PPRII
vy zuř i t	PRII
vy z ved nu t í	PPRSII
vy z ved á v a c í	PPRSSISI
vy zván ě t	PRII
vy z víd a t	PPRII
vy z věd a č	PPRIS
vy z věd a č stv í	PPRISSI
vy z věd ě t	PPRII
vy zář i t	PRII
vy získ a t	PRII
vy zýv a t	PRII
vy čar ova t	PRII
vy čas ova t	PRII
vy čenich a t	PRII
vy čep ova t	PRII
vy čerp a n ý	PRISI
vy čerp a t	PRII
vy čerp á v aj íc í	PRSSSSI
vy čerp á v a t	PRSSII
vy čes a t	PRII
vy čes á v a t	PRSSII
vy čich a t	PRII
vy čich nou t	PRII
vy čin i t	PRII
vy čist i t	PRII
vy čišť ova t	PRII
vy čk a t	PRII
vy čk á v a t	PRSSII
vy člen i t	PRII
vy čleň ova t	PRII
vy čmuch a t	PRII
vy čp ě t	PRII
vy čuch a t	PRII
vy čur a t	PRII
vy čár k ova t	PRIII
vy číh a t	PRII
vy číh nou t	PRII
vy čísl i t	PRII
vy čísl ova t	PRII
vy řad i t	PRII
vy řaz ova t	PRII
vy řez a t	PRII
vy řez á v a t	PRSSII
vy řeš en í	PRSI
vy řiz ova t	PRII
vy řiz ová n í	PRSSI
vy řád i t	PRII
vy říd i t	PRII
vy říz nou t	PRII
vy říz nu teln ý	PRSSI
vy šach ová v á n í	PRSSSSI
vy šetř ova c í	PRISI
vy šetř ova t	PRII
vy šetř ova tel	PRIS
vy škleb ova t	PRII
vy škobrt a t	PRII
vy škol en í	PRSI
vy škol i t	PRII
vy škrt a t	PRII
vy škrt nou t	PRII
vy škrt á v a t	PRSSII
vy škub a t	PRII
vy škub nou t	PRII
vy škvař i t	PRII
vy šlap a t	PRII
vy šlap ova t	PRII
vy šleh a t	PRII
vy šleh nou t	PRII
vy šláp nou t	PRII
vy šoup nou t	PRII
vy šplh a t	PRII
vy šplích a t	PRII
vy šplích nou t	PRII
vy šroub ova t	PRII
vy šroub ová v a t	PRSSII
vy štv a t	PRII
vy štíp a t	PRII
vy štíp nou t	PRII
vy štěbet a t	PRII
vy štěk nou t	PRII
vy švih nou t	PRII
vy ší t	PRI
vy ší v a t	PRSII
vy šťour a t	PRII
vy ťuk a t	PRII
vy ťuk á v a t	PRSSII
vy žad on i t	PRSII
vy žal ova t	PRII
vy žehl i t	PRII
vy žeh nou t	PRII
vy žen i t	PRII
vy žmol i t	PRII
vy žvan i t	PRII
vy žád a t	PRII
vy žád á n í	PRSSI
vy žíh a t	PRII
vy žín a t	PRII
vy žír a t	PRII
v zad u	PRS
vz bouz e t	PRII
vz bouř i t	PRII
vz dech nou t	PRII
vz dou t	PRI
vz dych a t	PRII
vz dych nou t	PRII
vz děl a n ý	PRISI
vz děl a t	PRII
vz děl a v a tel sk ý	PRISISII
vz děl a v a tel ův	PRISISI
vz děl á v a t	PRSSII
vz děl á v á n í	PRSSSSI
vze jí t	PRI
vze př í t	PRII
vz kaz	PR
vz kaz ova t	PRII
vz klíč i t	PRII
vz kvét a t	PRII
vz kyp ě t	PRII
vz káz a t	PRII
vz let ě t	PRII
vz lín a t	PRII
vz moc i	PRI
vz muž i t	PRII
vz nés t	PRI
v zor	PR
vz pamat ova t	PRII
vz paž i t	PRII
vz po mín k a	PPRII
vz pruž i t	PRII
vz pruž ova t	PRII
vz pír a t	PRII
vz přim ova t	PRII
vz přím i t	PRII
vz příč i t	PRII
vz ruš i t	PRII
vz ruš ova t	PRII
vz růst a t	PRII
vz tek	PR
vz tek a t	PRII
vz tek l e	PRSI
vz tek nou t	PRII
vz tyč i t	PRII
vz tyč ova t	PRII
v zýv a t	PRII
váb i t	RII
váb n ý	RSI
válč i t	RII
vápen at ě t	RSII
vápn i t	RII
vápn o	RS
vá t	RI
váz a n k a	RISII
váz a t	RII
váz nou t	RII
véz t	RI
víd a t	RII
víd á v a t	RSSII
vín o	RS
vír a	RI
ví t	RI
vít a t	RII
vítr	R
vítěz i t	RII
vítěz n ě	RSI
víč k ova t	RIII
víř i t	RII
v úst i t	PRII
vý kon	PR
vý kup n í	PRSI
vý let	PR
vý mluv n ost	PRSS
vý měn a	PRI
vý pot ek	PRI
vý po věď	PPR
vý raz n ý	PRSI
vý raz n ě	PRSI
vý rob a	PRI
vý rob c e	PRSI
vý rob ek	PRI
vý rob n í	PRSI
výsk a t	RII
výsk nou t	RII
vý sled ek	PRI
vý stup n í	PRSI
vý tah	PR
vý těž ek	PRI
výš e	RI
výš k a	RII
v čas	PR
včel a	RI
včel ař i t	RSII
v člen i t	PRII
v čleň ova t	PRII
věd a	RI
věd ec	RI
věd ec k ý	RIII
věd ě n í	RISI
věd ě t	RII
věk	R
věr n ost	RSS
větr á n í	RSSI
větv i t	RII
větř i t	RII
věz e n í	RISI
věz e t	RII
věz n i t	RSII
věč n ost	RSS
věč n ě	RSI
věř en í	RSI
věř i t	RII
věř i tel	RIS
věř íc í	RSI
věš e t	RII
věšt i t	RII
věž	R
v řad i t	PRII
v řaz ova t	PRII
v řaď ova t	PRII
v řez a t	PRII
v řez á v a t	PRSSII
vřísk a t	RII
vřísk nou t	RII
vř í t	RII
v řít i t	PRII
v říz nou t	PRII
v šept nou t	PRII
v štěp ova t	PRII
vším a t	RII
v ší v a t	PRSII
vůl	R
vůl e	RI
vůz	R
za baf a t	PRII
za baf nou t	PRII
za bahn i t	PRII
za bahň ova t	PRII
za bal ený	PRS
za bal i t	PRII
za bal ova t	PRII
za bav i t	PRII
za bav ova t	PRII
za bedn i t	PRII
za bedn ěn ec	PRSI
za bedň ova t	PRII
za beton ova t	PRII
za blik a t	PRII
za blýsk a t	PRII
za blýsk nou t	PRII
za bod a t	PRII
za bod nou t	PRII
za bod á v a t	PRSSII
za bol e t	PRII
za bouch nou t	PRII
za bouch á v a t	PRSSII
za bouř i t	PRII
za boč ova t	PRII
za boř i t	PRII
za brn ě t	PRII
za brouk a t	PRII
za brous i t	PRII
za bruč e t	PRII
za bruš ova t	PRII
za brán i t	PRII
za bubn ova t	PRII
za bud ova t	PRII
za buš i t	PRII
za bydl e t	PRII
za bíl i t	PRII
za bý v a t	PRSII
za běh a t	PRII
za běh á v a t	PRSSII
za běl a t	PRII
za cement ova t	PRII
za chlad i t	PRII
za chlaz ova t	PRII
za chov a t	PRII
za chov á n í	PRSSI
za chov á v a t	PRSSII
za chraň ova t	PRII
za chrchl a t	PRII
za chrán i t	PRII
za cht í t	PRII
za chut n a t	PRSII
za chví v a t	PRSII
za chvě t	PRI
za chyc ova t	PRII
za chyt i t	PRII
za chyt nou t	PRII
za cink a t	PRII
za cink nou t	PRII
za clon i t	PRII
za cloň ova t	PRII
za couv a t	PRII
za cp á v a t	PRSSII
za cuk a t	PRII
za cvak a t	PRII
za cvak nou t	PRII
za cvič i t	PRII
za cvič ova t	PRII
za cvál a t	PRII
za cák a t	PRII
za cíl i t	PRII
zad ek	RI
zad eček	RS
za dlab á v a t	PRSSII
za dluž i t	PRII
za dluž ova t	PRII
za dou t	PRI
za drh nou t	PRII
za drh ova t	PRII
za drž ova t	PRII
za dum a t	PRII
za dup a t	PRII
za dup nou t	PRII
za dup á v a t	PRSSII
za dus i t	PRII
za duš ova t	PRII
za dáv i t	PRII
za dír a t	PRII
za dív a t	PRII
za dých á v a t	PRSSII
za dým a t	PRII
za děl a t	PRII
za děl á v a t	PRSSII
za dř í t	PRII
za fix ova t	PRII
za flák a t	PRII
za fouk nou t	PRII
za frk a t	PRII
za haj ova t	PRII
za hal i t	PRII
za hal ova t	PRII
za han b en ě	PRISI
za han b i t	PRIII
za haz ova t	PRII
za haš en í	PRSI
za hlad i t	PRII
za hlaz ova t	PRII
za hled ě t	PRII
za hloub a t	PRII
za hn a t	PRII
za hní t	PRI
za hní v a t	PRSII
za hnízď ova t	PRII
za hod i t	PRII
za hoj i t	PRII
za hospod ař i t	PRSII
za houk nou t	PRII
za houp a t	PRII
za hrab a t	PRII
za hrab ova t	PRII
za hrad i t	PRII
za hran ič n í	PRSSI
za hran ič í	PRSI
za hraz ova t	PRII
za hrk a t	PRII
za hr nou t	PRII
za hrom ova t	PRII
za hrot i t	PRII
za hroz i t	PRII
za hryz nou t	PRII
za hráb nou t	PRII
za hrá t	PRI
za hrá v a t	PRSII
za hub i t	PRII
za hulák a t	PRII
za hušť ova t	PRII
za hvízd a t	PRII
za hvízd nou t	PRII
za háj i t	PRII
za hák ova t	PRII
za ház e t	PRII
za háč k ova t	PRIII
za hýb a t	PRII
za hřm í t	PRII
za hřm ě t	PRII
za hřá t	PRI
za hřím a t	PRII
za j at ec	PRSI
za je t	PRI
za jezd i t	PRII
za ječ e t	PRII
za jiskř i t	PRII
za jist é	PRI
za jizv i t	PRII
za jizv ova t	PRII
za jišt ěn í	PRSI
za jišť ova t	PRII
za jás a t	PRII
za jíd a t	PRII
za jím a v ý	PRISI
za jí t	PRI
za jížd ě n í	PRISI
za kal i t	PRII
za kal ova t	PRII
za kap a t	PRII
za kap á v a t	PRSSII
za kaz ova t	PRII
za kec a t	PRII
za klap nou t	PRII
za klep a t	PRII
za klep nou t	PRII
za kles nou t	PRII
za kles nu t í	PRSII
za kles nut ý	PRRI
za kle t í	PRII
za klop i t	PRII
za klopýt nou t	PRII
za kloň ova t	PRII
za kláp ě t	PRII
za klí n a t	PRSII
za klín ova t	PRII
za klí t	PRI
za klíž i t	PRII
za kmit a t	PRII
za kokt a t	PRII
za koléb a t	PRII
za kolís a t	PRII
za konč i t	PRII
za konč ova t	PRII
za kop a t	PRII
za kop nou t	PRII
za kop á v a t	PRSSII
za kotv en í	PRSI
za kotv i t	PRII
za kotv ova t	PRII
za kouk a t	PRII
za koul e t	PRII
za koup i t	PRII
za kous nou t	PRII
za kous á v a t	PRSSII
za kouř i t	PRII
za kořen i t	PRII
za kořeň ova t	PRII
za kroj i t	PRII
za krout i t	PRII
za krouž i t	PRII
za kruc ova t	PRII
za krv av ě t	PRSII
za krv ác e t	PRSII
za krám ova t	PRII
za krý t	PRI
za krý v a t	PRSII
za kuk a t	PRII
za kul ac ova t	PRSII
za kul at i t	PRSII
za kup ova t	PRII
za kut a t	PRII
za kutál e t	PRII
za kuř ova t	PRII
za kvas i t	PRII
za kvaš ova t	PRII
za kyd a n ý	PRISI
za kys a t	PRII
za kys e l ová n í	PRISSSI
za kys nou t	PRII
za kys á v a t	PRSSII
za káp nou t	PRII
za káz a t	PRII
za kód ova t	PRII
za křik nou t	PRII
za křik ova t	PRII
za křiv i t	PRII
za křiv ova t	PRII
za křič e t	PRII
za lahod i t	PRII
za lak ova t	PRII
za lap a t	PRII
za lecht a t	PRII
za lek nou t	PRII
za lem ova t	PRII
za lesk nou t	PRII
za les n i t	PRSII
za les ň ova t	PRSII
za let ova t	PRII
za let ě t	PRII
za lh a t	PRII
za lh á v a t	PRSSII
za lichot i t	PRII
za list ova t	PRII
za lit ova t	PRII
za lom i t	PRII
za lov i t	PRII
za lož en í	PRSI
za lož en ý	PRSI
za lož i t	PRII
za lát a t	PRII
za lét a t	PRII
za lét nou t	PRII
za lé v a t	PRSII
za léz a t	PRII
za léz t	PRI
za líc ova t	PRII
za lí t	PRI
za lít a t	PRII
za lít á v a t	PRSSII
za líz a t	PRII
za manévr ova t	PRII
za mask ova t	PRII
za mast i t	PRII
za maz a t	PRII
za maz áv ač	PRSS
za mačk a t	PRII
za mačk á v a t	PRSSII
z amerik an iz ova t	PRSSII
za met a t	PRII
za meč e t	PRII
za mešk a t	PRII
za mešk á v a t	PRSSII
za mhouř i t	PRII
za mhuř ova t	PRII
za mil ova n ý	PRISI
za mil ova n ě	PRISI
za mil ova t	PRII
za mil ová v a t	PRSSII
za mk nou t	PRII
za mlouv a t	PRII
za mluv i t	PRII
za mlč ova t	PRII
za mlž i t	PRII
za mlž ova t	PRII
za mont ova t	PRII
za mot a t	PRII
za mot á v a t	PRSSII
za moř en ý	PRSI
za mraz i t	PRII
za mrač en ost	PRSS
za mrač i t	PRII
za mrk a t	PRII
za mrsk a t	PRII
za mrz e t	PRII
za myk a t	PRII
za mysl e t	PRII
za myšl e n ý	PRISI
za myšl e n ě	PRISI
za máv a t	PRII
za máv nou t	PRII
za máč e t	PRII
za mích a t	PRII
za mít a t	PRII
za mít nou t	PRII
za míř i t	PRII
za mýšl e t	PRII
za měň ova t	PRII
za měř ova t	PRII
za mř í t	PRII
za mříž ova t	PRII
za na řík a t	PPRII
za nech a t	PRII
za nech á v a t	PRSSII
za not ova t	PRII
za nož i t	PRII
za nož ova t	PRII
za náš e t	PRII
za nés t	PRI
za nýt ova t	PRII
za o bal i t	PPRII
za o bal ova t	PPRII
za o krouh l i t	PPRSII
za o krouh l ova t	PPRSII
za olej ova t	PRII
za o patř i t	PPRII
za o patř ova t	PPRII
za ostř ova t	PRII
za pad aj íc í	PRSSI
za pad a t	PRII
za pad nou t	PRII
za pad á v a t	PRSSII
za pal ova t	PRII
za pamat ova t	PRII
za pamat ová n í	PRSSI
za park ova t	PRII
za pař i t	PRII
za pař ova t	PRII
za paž i t	PRII
za pečet i t	PRII
za pich ova t	PRII
za pil ova t	PRII
za pis ova t	PRII
za pis ova tel ův	PRISI
za plak a t	PRII
za pla nou t	PRII
za plat i t	PRII
za plav a t	PRII
za plav i t	PRII
za plav ova t	PRII
za plaš i t	PRII
za plaš ova t	PRII
za plesk a t	PRII
za plev el i t	PRRII
za pliv a t	PRII
za pln i t	PRII
za pln ěn ý	PRSI
za plomb ova t	PRII
za plác a t	PRII
za plét a t	PRII
za plét á v a t	PRSSII
za po chyb ova t	PPRII
za pot i t	PRII
za poušt ě t	PRII
za po víd a t	PPRII
za po věd ě t	PPRII
za po věz e n ý	PPRISI
za po ší t	PPRI
za po ší v a t	PPRSII
za prac ova t	PRII
za prask a t	PRII
za prask nou t	PRII
za pr a t	PRII
za prav i t	PRII
za prav ova t	PRII
za praž i t	PRII
za pros i t	PRII
za prsk nou t	PRII
za prásk a t	PRII
za prásk nou t	PRII
za práš en ý	PRSI
za práš i t	PRII
za prš e t	PRII
za ps a t	PRII
za pud i t	PRII
za pudr ova t	PRII
za pust i t	PRII
za puz ova t	PRII
za pytl ač i t	PRSII
za páj e t	PRII
za pál i t	PRII
za pátr a t	PRII
za péc i	PRI
za pék a t	PRII
za pích a t	PRII
za pích nou t	PRII
za pík a t	PRII
za pín a t	PRII
za píp nou t	PRII
za pěn i t	PRII
za pě t	PRI
za při sáh nou t	PPRII
za pří sah a t	PPRII
za půjč i t	PRII
za půjč ova t	PRII
za rad ova t	PRII
z aranž ova t	PRII
za raz i t	PRII
za raž en ě	PRSI
za rd í v a t	PRISII
za re ag ova t	PPRII
za re cit ova t	PPRII
za registr ova t	PRII
za rez av ě t	PRSII
za rmout i t	PRII
za rmuc ova t	PRII
za roj i t	PRII
za rol ova t	PRII
za ros i t	PRII
za ruč i t	PRII
za ruč ova t	PRII
za ryb n i t	PRSII
za rám ova t	PRII
za ráž e t	PRII
za rýp a t	PRII
za rýp nou t	PRII
za rý t	PRI
za rý v a t	PRSII
za růst a t	PRII
za růž ov ě t	PRSII
za sch nou t	PRII
za sek a t	PRII
za sek á v a t	PRSSII
za skl í v a t	PRISII
za skoč i t	PRII
za skříp a t	PRII
za skříp nou t	PRII
za slouž i t	PRII
za sluh ova t	PRII
za slz e t	PRII
za smaž ova t	PRII
za smol i t	PRII
za snoub i t	PRII
za snub ova t	PRII
za sn í t	PRII
za sn í v a t	PRISII
za sněž i t	PRII
za sol ova t	PRII
za sp a t	PRII
za sp á v a t	PRSSII
za star a t	PRII
za sta t	PRI
za stih nou t	PRII
za stiň ova t	PRII
za ston a t	PRII
za stoup en í	PRSI
za stoup i t	PRII
za straš i t	PRII
za straš ova t	PRII
za strk a t	PRII
za strk ova t	PRII
za strk á v a t	PRSSII
za strč i t	PRII
za stá n í	PRSI
za stá v a t	PRSII
za stín i t	PRII
za stír a t	PRII
za stýsk a t	PRII
za střel i t	PRII
za střel ova t	PRII
za střeš i t	PRII
za střeš ova t	PRII
za střík a t	PRII
za stříl e t	PRII
za stř í t	PRII
za svin i t	PRII
za svít i t	PRII
za svěc ova t	PRII
za svět i t	PRII
za syc ova t	PRII
za syk nou t	PRII
za syp á v a t	PRSSII
za syt i t	PRII
za syč e t	PRII
za tah a t	PRII
za taj i t	PRII
za tanc ova t	PRII
za tanč i t	PRII
za tav i t	PRII
za tem n i t	PRSII
za tem n ě t	PRSII
za tem ň ova t	PRSII
za tesk n i t	PRSII
za tik a t	PRII
za tlač i t	PRII
za tlač ova t	PRII
za tlesk a t	PRII
za tlouk a t	PRII
za t nou t	PIII
za toul a t	PRII
za touž i t	PRII
za toč i t	PRII
za trac ova t	PRII
za trat i t	PRII
za trh a t	PRII
za trh nou t	PRII
za trh ova t	PRII
za trh á v a t	PRSSII
za troub i t	PRII
za tráp en ý	PRSI
za tráv n i t	PRSII
za trén ova t	PRII
za tuch nou t	PRII
za tvrd i t	PRII
za tvrd nou t	PRII
za táč e t	PRII
za táč k a	PRII
za ték a t	PRII
za tír a t	PRII
za tíž en í	PRSI
za tíž en ý	PRSI
za tíž i t	PRII
za týk a t	PRII
za těž k a t	PRIII
za těž ova t	PRII
za třep a t	PRII
za třás t	PRI
za tř í t	PRII
za u j a t ý	PPRIII
za u j e t í	PPRIII
z auto mat iz ova t	PRRSII
za uč ova t	PRII
za vad i t	PRII
za val ova t	PRII
za vaz ova t	PRII
za vaz uj íc í	PRSSI
za vel e t	PRII
za vesl ova t	PRII
za vin i t	PRII
za viň ova t	PRII
za vlaž i t	PRII
za vlaž ova t	PRII
za vlád nou t	PRII
za vlá t	PRI
za vléc i	PRI
za vlék a t	PRII
za vlík a t	PRII
za vod n i t	PRSII
za vol a t	PRII
za von ě t	PRII
za vrt a t	PRII
za vrt á v a t	PRSSII
za vrt ě t	PRII
za vrz a t	PRII
za vrz nou t	PRII
za vrávor a t	PRII
za vrč e n í	PRISI
za vrč e t	PRII
za vtip k ova t	PRIII
za vz dych a t	PPRII
za vz dych nou t	PPRII
za vál e t	PRII
za váz a n ý	PRISI
za váz e t	PRII
za víj e t	PRII
za vír a t	PRII
za ví t	PRI
za vít a t	PRII
za víč k ova t	PRIII
za víř i t	PRII
za výsk nou t	PRII
za věs i t	PRII
za věš ova t	PRII
za vř e n ý	PRISI
za vřísk a t	PRII
za vřísk nou t	PRII
za vř í t	PRII
za vš iv i t	PRSII
za zd í v a t	PRISII
za zelen a t	PRII
za zim ova t	PRII
za znam en a t	PRSII
za znam en á v a t	PRSSSII
za zn í t	PRII
za zub i t	PRII
za zvon i t	PRII
za zvuč e t	PRII
za čad i t	PRII
za čaz ova t	PRII
za čep ova t	PRII
za čepýř i t	PRII
za čern a t	PRII
za čern i t	PRII
za červen a t	PRII
za čes a t	PRII
za čist i t	PRII
za čisť ova t	PRII
za čišť ova t	PRII
za člen i t	PRII
za čleň ova t	PRII
za čmár a t	PRII
za čoud i t	PRII
za čuz ova t	PRII
za řad i t	PRII
za řad i teln ý	PRISI
za řaz en í	PRSI
za řaz en ý	PRSI
za řaz ova t	PRII
za řek nou t	PRII
za řez á v a t	PRSSII
za řiz ova t	PRII
za řiz ova tel	PRIS
za řv a t	PRII
za řád i t	PRII
za říc i	PRI
za říd i t	PRII
za řík a t	PRII
za říz en í	PRSI
za říz nou t	PRII
za šept a t	PRII
za šept nou t	PRII
za šetř i t	PRII
za šifr ova t	PRII
za šilh a t	PRII
za škobrt a t	PRII
za škobrt nou t	PRII
za škobrt á v a t	PRSSII
za škol en í	PRSI
za škol i t	PRII
za škrt a t	PRII
za škrt i t	PRII
za škrt nou t	PRII
za škrt á v a t	PRSSII
za škub a t	PRII
za šlap a t	PRII
za šleh a t	PRII
za šláp nou t	PRII
za šmel i t	PRII
za šmodrch a t	PRII
za šmodrch á v a t	PRSSII
za šmudl a t	PRII
za šněr ova t	PRII
za šoup nou t	PRII
za špendl i t	PRII
za špin i t	PRII
za špič at i t	PRSII
za šplouch a t	PRII
za šplouch nou t	PRII
za šroub ova t	PRII
za šroub ová v a t	PRSSII
za štip ova t	PRII
za štíp nou t	PRII
za štěk nou t	PRII
za šum ě t	PRII
za šust i t	PRII
za švih a t	PRII
za švih nou t	PRII
za švindl ova t	PRII
za ší t	PRI
za ší v a t	PRSII
za ťap a t	PRII
za ťuk a t	PRII
za žehn a t	PRII
za žehn á v a t	PRSSII
za žeh ova t	PRII
za žh nou t	PRII
za ži t í	PRII
za ži t ý	PRII
za žíh a t	PRII
za ží t	PRI
z babr a t	PRII
z barv i t	PRII
z barv ova t	PRII
z bav i t	PRII
z bav ova t	PRII
z bloud i t	PRII
z blázn i t	PRII
z bod a t	PRII
z boh at nou t	PRSII
z bour a t	PRII
z boř i t	PRII
z braň ova t	PRII
z brous i t	PRII
z bruš ova t	PRII
z brázd i t	PRII
z bubn ova t	PRII
z bud ova t	PRII
z buj e t	PRII
z bád a t	PRII
z básn i t	PRII
z básň ova t	PRII
z bíd ač i t	PRSII
z bý v aj íc í	PRSSSI
z běh a t	PRII
z běl a t	PRII
z běl i t	PRII
z centr al iz ova t	PRSSII
z cenzur ova n ý	PRISI
z chlad i t	PRII
z chlad nou t	PRII
z chlaz ova t	PRII
z chod i t	PPII
z chrup nou t	PRII
z civil iz ova t	PRSII
z ciz ova t	PRII
z cuch a t	PRII
z cuker n at ě t	PRSSII
z dan i t	PRII
z dar	PR
z daň ova c í	PRISI
z daň ova t	PRII
z dař i t	PRII
z de form ova t	PPRII
z de gener ova t	PPRII
z div oč e t	PRRII
z dluž ova t	PRII
z do kon a l i t	PPRISII
z do kon a l i teln ý	PPRISISI
z do kon a l ova t	PPRISII
z dou t	PRI
z dou v a t	PRSII
zdrav i t	RII
zdrav ot nic tv í	RSSSI
zdrav ot n í	RSSI
zdrav ý	RI
zdrav ě	RI
z draž i t	PRII
z draž ova t	PRII
z drb a t	PRII
z drb nou t	PRII
z drc en ě	PRSI
z drt i t	PRII
z dráp a t	PRII
z drás a t	PRII
z drž e nliv ost	PRISS
z drž e t	PRII
z dus a t	PRII
zdvih a t	RII
zdvih nou t	RII
z dvoř i l e	PRISI
z dvoř i l ost	PRISS
z dvoř i l ý	PRISI
zd í t	RII
z děd i t	PRII
z děs i t	PRII
z dět in št ě t	PRSSII
z dřím nou t	PRII
zed nič i t	RRII
zed ník	RS
ze dř í t	PRII
z elektr iz ova t	PRSII
zelen a t	RII
zelen in a	RSI
zelen ý	RI
zelen ě	RI
zeleň	R
ze mdl é v a t	PRISII
ze mdl í t	PRII
ze mdl í v a t	PRISII
zem sk ý	RII
zem ák	RS
ze ps ou t	PRSI
ze pt a t	PRII
ze sil ova t	PRII
ze sin a t	PRII
ze slab i t	PRII
ze slab ova t	PRII
ze sláb nou t	PRII
ze smut ň ova t	PRSII
ze star a t	PRII
ze styl iz ova t	PRSII
ze stát n i t	PRSII
ze stát ň ova t	PRSII
ze svět l ová n í	PRSSSI
ze síl i t	PRII
ze síť ova t	PRII
ze zelen a t	PRII
zeď	R
ze šed iv ě t	PRSII
ze špič at ě t	PRSII
ze šíř i t	PRII
ze žlout nou t	PRII
z falš ova t	PRII
z faš iz ova t	PRSII
z feder al iz ova t	PRSSII
z filtr ova t	PRII
z fix ova t	PRII
z form ova t	PRII
z harmon iz ova t	PRSII
z has i t	PRII
z has nou t	PRII
z has í n a t	PRISII
z hloup nou t	PRII
z hlt nou t	PRII
z hnus i t	PRII
z hněd nou t	PRII
z hoj i t	PRII
z host i t	PRII
z hotov en í	PRSI
z hotov i t	PRII
z hotov ova t	PRII
z houb n ý	PRSI
z houst nou t	PRII
z hroz i t	PRII
z hrub nou t	PRII
z hub en ě t	PRSII
z hub nou t	PRII
z hust i t	PRII
z hušť ova t	PRII
z ideal iz ova t	PRSII
zim a	RI
zim n í	RSI
zim n ík	RSS
zim ova t	RII
z instrument ova t	PRII
zisk	R
z jan č i t	PRSII
z jas n ě t	PRSII
z je t	PRI
z jev i t	PRII
z jež i t	PRII
z jizv i t	PRII
z jišť ova t	PRII
z kadeř i t	PRII
z kal i t	PRII
z kamen ěl ý	PRSI
z kamen ě t	PRII
z kap al n i t	PRSSII
z kap al n ě t	PRSSII
z kap al ň ova t	PRSSII
z kapital iz ova t	PRSII
z kaz i t	PRII
z klam a n ě	PRISI
z klam a t	PRII
z klam á n í	PRSSI
z klid n ě t	PRSII
z koléb a t	PRII
z kombin ova t	PRII
z kom pon ova t	PRRII
z kompost ova t	PRII
z konejš i t	PRII
z kon stru ova t	PRRII
z kontrol ova t	PRII
z ko ordin ova t	PPRII
z kop a t	PRII
z ko rmout i t	PPRII
z kor n at ě t	PRSSII
z kos i t	PRII
z kost n at ě t	PRSSII
z koum a t	PRII
z koup a t	PRII
z kouš k a	PRII
z krac ova t	PRII
z krm i t	PRII
z krm ova t	PRII
z krop i t	PRII
z krot i t	PRII
z krot nou t	PRII
z krout i t	PRII
z krv av ě t	PRSII
z krv ác e t	PRSII
z krystal iz ova t	PRSII
z kráp ě t	PRII
z krás n ě t	PRSII
z krát i t	PRII
z krát k a	PRII
z kráš l i t	PRSII
z kráš l ova t	PRSII
z kul at i t	PRSII
z kul at ě t	PRSII
z kus i t	PRII
z kuš en ost	PRSS
z kuš en ý	PRSI
z kvas i t	PRII
z kvét a t	PRII
z kys a t	PRII
z kys nou t	PRII
z káp nou t	PRII
z křeh nou t	PRII
z křiv i t	PRII
z křís nou t	PRII
z kříž i t	PRII
zlat i t	RII
zlat o	RS
zlat ý	RI
zl e	RI
z lecht a t	PRII
z lek a t	PRII
z lek nou t	PRII
z len iv ě t	PRSII
z len oš i t	PRSII
z lev n i t	PRSII
z lid ov ě t	PRSII
z lid št i t	PRSII
z likvid ova t	PRII
z lis ova t	PRII
zl o	RS
zl ob i t	RSII
z lom en in a	PRSSI
z lom i t	PRII
z lák a t	PRII
z lám a t	PRII
z léz a t	PRII
z léz t	PRI
z lít a t	PRII
zl ý	RI
z magnet iz ova t	PRSII
z magnet ova t	PRII
z mal ova t	PRII
z map ova t	PRII
z mar n i t	PRSII
z mat ek	PRI
z mat en ý	PRSI
z maz a t	PRII
z mačk a t	PRII
z mař i t	PRII
z mešk a t	PRII
z miz e t	PRII
z mlaz ova t	PRII
z mlk a t	PRII
z mlk nou t	PRII
z mlád nou t	PRII
z mlát i t	PRII
z množ i t	PRII
z moc i	PRI
z mont ova t	PRII
z moral iz ová n í	PRSSSI
z mord ova t	PRII
z mot a t	PRII
z moudř e t	PRII
z mraz i t	PRII
z mrsk a t	PRII
z mrz ač i t	PRSII
z mrz e t	PRII
z mrz nou t	PRII
z muchl a t	PRII
z muč i t	PRII
z muž n ě t	PRSII
z mách a t	PRII
z máh a t	PRII
z más t	PRI
z máč e t	PRII
z máčk nou t	PRII
z mín i t	PRII
z mír a t	PRII
z mít a t	PRII
z mít á n í	PRSSI
z mýl i t	PRII
z měk nou t	PRII
z měk č ova t	PRSII
zn a l ec	RISI
zn a l ost	RISS
znam en a t	RSII
znač i t	RII
znač k a	RII
znač n ý	RSI
znač n ě	RSI
z ne svět i t	PPRII
z ne tvoř i t	PPRII
z ne u ct í t	PPPRII
z ne u zn á v a t	PPPRSSII
z ne u ží v a t	PPPRSII
z ne čist i t	PPRII
z ne čisť ova t	PPRII
z ne čišť ova t	PPRII
z nič en ý	PRSI
z nič en ě	PRSI
z nič i t	PRII
z norm al iz ova t	PRSSII
z norm ova t	PRII
z nud i t	PRII
zn ám ý	RRI
z ná rod n i t	PPRSII
z ná rod ň ova t	PPRSII
z ná sil n i t	PPRSII
z ná sil ň ova t	PPRSII
z násob i t	PRII
z násob ova n ý	PRISI
z násob ova t	PRII
zn á t	RSI
zn í t	RII
zn ě n í	RISI
zob a t	RII
z obec n i t	PRSII
zob nou t	RII
z ocel i t	PRII
z ocel ova t	PRII
z od po víd a t	PPPRII
z od po věd n ost	PPPRSS
z od po věd n ě	PPPRSI
z o hyzd i t	PPRII
z o hyzď ova t	PPRII
z o hýb a t	PPRII
z o stouz e t	PPRII
z ostř i t	PRII
z ostř ova t	PRII
z ote vír a t	PRRII
z otroč i t	PRII
z otroč ova t	PRII
z ot vír a t	PPRII
zoub k ova t	RIII
zouf a l e	RISI
zouf al ý	RSI
zouf a t	RII
zou t	RI
zou v a t	RSII
z oxid ova t	PRII
z oč i t	PRII
z oškliv ova t	PRII
z oškliv ě t	PRII
z pacht ova t	PRII
z pan ák ova t	PRSII
z patl a t	PRII
z peněž i t	PRII
z pevn i t	PRII
z pečet i t	PRII
z plak a t	PRII
z plen i t	PRII
z pleš at ě t	PRSII
z plod i t	PRII
z poc en ý	PRSI
z poet iz ova t	PRSII
z po hlav k ova t	PPRIII
z pol ar iz ova t	PRSSII
z po lám a t	PPRII
z popel av ě t	PRSII
z popel n i t	PRSII
z po ráž e t	PPRII
z pot i t	PRII
z po víd a t	PPRII
z po zor ova t	PPRII
z požď ova c í	PRISI
z požď ova t	PRII
z prac ova t	PRII
z prac ová n í	PRSSI
z prac ová v a t	PRSSII
z prav i t	PRII
z prav ova t	PRII
z praž i t	PRII
z pro hýb a t	PPRII
z pro střed k ova n ý	PPRIISI
z pro střed k ova n ě	PPRIISI
z pro střed k ova t	PPRIII
z pro střed k ová n í	PPRISSI
z pro střed k ová v a t	PPRISSII
z prásk a t	PRII
z pust i t	PRII
z pust nou t	PRII
z pust oš i t	PRSII
z pyt ova t	PRII
z pyš n ě t	PRSII
z pék a t	PRII
z pí v aj íc í	PRSSSI
z pí v at	PRSS
z pěn i t	PRII
z pře ház e t	PPRII
z pře hýb a t	PPRII
z pře lám a t	PPRII
z přesň ova t	PRII
z pře trh a t	PPRII
z přím i t	PRII
z příč i t	PRII
z rad i t	PRII
zra l ý	RSI
z ran i t	PRII
z ran ěn í	PRSI
z raz ova t	PRII
z raň ova t	PRII
z real iz ova t	PRSII
z redig ova t	PRII
z reduk ova t	PRII
z re form ova t	PPRII
z re gener ova t	PPRII
z regul ova t	PRII
z re kon stru ova t	PPRRII
z restaur ova t	PRII
z re vid ova t	PPRII
z rez av ě t	PRSII
zrn í	RI
zrn íč k o	RSIS
z rob i t	PRII
z rod i t	PRII
z ros i t	PRII
z roz en í	PPPI
z rud nou t	PRII
z ruš en ý	PRSI
z ruš i t	PRII
z ruš ova t	PRII
z rychl i t	PRII
z rychl ova t	PRII
zrz av ý	RSI
zrz av ě t	RSII
zrá n í	RSI
zrá t	RI
z rým ova t	PRII
z rýp a t	PRII
z rý t	PRI
z sin a t	PRII
z tah a t	PRII
z taj i t	PRII
z tem n i t	PRSII
z ten č i t	PRSII
z ten č ova t	PRSII
z tep a t	PRII
z tich a	PRI
z tiš i t	PRII
z tiš ová n í	PRSSI
z tlouc i	PRI
z tloust nou t	PRII
z tlum i t	PRII
z tm av nou t	PRSII
z tm av ova t	PRSII
z trat i t	PRII
z trest a t	PRII
z trh a t	PRII
z trh ova t	PRII
z trh á v a t	PRSSII
z trác e t	PRII
z trát a	PRI
z trát ov ý	PRSI
z trýzn i t	PRII
z tuch nou t	PRII
z tup i t	PRII
z tup ě t	PRII
z tuč n ě t	PRSII
z tuž i t	PRII
z tvrd i t	PRII
z tvár n i t	PRSII
z tvár ň ova t	PRSII
z téc i	PRI
z týr a t	PRII
z těž k nou t	PRIII
z těž ova t	PRII
zub	R
zub at ý	RSI
zub i t	RII
z uhel n at ě t	PRSSII
z u líb a t	PPRII
z u líb á n í	PPRSSI
z u trh a t	PPRII
zuř i t	RII
zuř iv ě	RSI
z u šlecht i t	PPRII
z u šlechť ova t	PPRII
z už ova t	PRII
z valch ova t	PRII
z vandr ova t	PRII
z ved nou t	PRII
z veleb i t	PRII
z verb ova t	PRII
z vesel i t	PRII
z vikl a t	PRII
z viř ova t	PRII
z vlaž i t	PRII
z vlaž ova t	PRII
z vlh č i t	PRSII
z vlh č ova t	PRSII
z vln i t	PRII
z vlád nou t	PRII
z vlád nu t í	PRSII
z vláč n i t	PRSII
z vlň ova t	PRII
z vod n at ě t	PRSSII
z vol i t	PRII
z vol n i t	PRSII
z vol ň ova t	PRSII
zvon ek	RI
zvon ov ě	RSI
z vrac e t	PRII
z vrt a t	PRII
z vrt nou t	PRII
z vrt á v a t	PRSSII
z vrz a t	PRII
z vrz nou t	PRII
zvuk	R
zvuč e t	RII
zvuč i t	RII
z vyš ová n í	PRSSI
z váb i t	PRII
z vál e t	PRII
zv á t	RSI
z víd a t	PRII
z vítěz i t	PRII
z víř i t	PRII
z výš en í	PRSI
z výš i t	PRII
z věd a v ost	PRISS
z věd a v ý	PRISI
z věd ě t	PRII
z větr a t	PRII
z větr á v a t	PRSSII
z věč n i t	PRSII
z věč ň ova t	PRSII
zá bav a	PRI
zá had n ý	PRSI
zá hlav í	PRI
zá jem	PR
zá kon	PR
zá kon it ý	PRII
zá kon n ý	PRSI
zá loh ova t	PRII
zá mek	PR
zá moř í	PRI
zá paš ek	PRI
zá sob a	PRI
zá sob i t	PRII
zá sob ník	PRS
zá sob ova t	PRII
zá stup	PR
zá stěr a	PRI
zá stěr k a	PRII
zá vis l ý	PRSI
zá věr	PR
zá znam	PR
zář en í	RSI
zář íc í	RSI
získ a t	RII
získ á n í	RSSI
získ á v a t	RSSII
získ á v á n í	RSSSSI
zív a t	RII
zív nou t	RII
z úkol ova t	PRII
z ú čast n i t	PPRSII
z úž i t	PRII
z čechr a t	PRII
z čern a t	PRII
z čern á v a t	PRSSII
z červen a t	PRII
z červ iv ě t	PRSII
z čeř i t	PRII
z češť ova t	PRII
z řed i t	PRII
z řeď ova t	PRII
z říc i	PRI
z řík a t	PRII
z řít i t	PRII
z ů sta t	PPRI
z ů sta v i t	PPRSII
z ů stá v a t	PPRSII
z žen št i t	PRSII
ú ct a	PRI
ú mr t í	PRII
ú sek ov ý	PRSI
ú smě v	PRS
ú spě ch	PRI
úst a	RI
úst i t	RII
ú stup ek	PRI
úst í	RI
ú střed ní	PRS
ú střed í	PRI
ú trž ek	PRI
ú těš n ý	PRSI
ú zem í	PRI
úz k o	RIS
úz k ost	RIS
úz k ost n ě	RISSI
ú čast	PR
ú čast en stv í	PRSSI
ú čast n i t	PRSII
ú čin n ý	PRSI
ú řad	PR
ú řad ova t	PRII
ú řed n í	PRSI
ú řed ník	PRS
ú řed n ě	PRSI
úž i t	RII
čaloun i t	RII
čaloun ova t	RII
čap a t	RII
čap nou t	RII
čas	R
čas n ě	RSI
čas ova t	RII
čas ov ě	RSI
čech iz ova t	RSII
čechr a t	RII
ček a t	RII
ček á n í	RSSI
čel i t	RII
čenich a t	RII
čepejř i t	RII
čep ova t	RII
čepýř i t	RII
čern i t	RII
čern á	RS
čern ý	RI
čerp a t	RII
čert	R
čert i t	RII
červen	R
červen a t	RII
červen ec	RI
červen i t	RII
červen ý	RI
červen ě	RI
červ iv ě t	RSII
čes a t	RII
čes k o	RIS
čes k y	RII
čes k ý	RII
čest	R
čest n ý	RSI
čest n ě	RSI
čet a	RI
čet n ý	RSI
čeř i t	RII
čeř iv ost	RSS
češ t in a	RISI
čich	R
čich a t	RII
čin	R
čin n ost	RSS
čin n ý	RSI
čin n ě	RSI
čist i t	RII
čist ot a	RSI
čist ě	RI
člen	R
člen i t	RII
človíč ek	RI
člověk	R
člán k ova t	RIII
čmuch a t	RII
čmuch nou t	RII
čmár a t	RII
čmár nou t	RII
čp ě t	RII
čtver ec	RI
čtver eč n í	RSSI
čtvrt i t	RII
čtvrť	R
čuch a t	RII
čuch nou t	RII
čum ě t	RII
čur a t	RII
čvacht a t	RII
čár a	RI
čár a t	RII
čár k ova t	RIII
čár ov ý	RSI
část	R
část eč n ě	RSSI
část ic e	RSI
část k a	RII
číh a l	RIS
číh a t	RII
čísl o	RS
čísl ova t	RII
ďob a t	RII
řad ic í	RSI
řad i t	RII
řas i t	RII
řed i t	RII
řed i tel	RIS
řeht a t	RII
řemesl n ý	RSI
řemesl o	RS
řev	R
řez a t	RII
řez nic k y	RSII
řez n ík	RSS
řeš en í	RSI
řid i č	RIS
řv á t	RSI
řád	R
řád i t	RII
řád k ova t	RIII
řád k ová n í	RISSI
řád n ý	RSI
říc i	RI
říd i c í	RISI
říd nou t	RII
říd íc í	RSI
řík a t	RII
říz en í	RSI
říz en ý	RSI
šach ov nic e	RSSI
šavl e	RI
šed in y	RSI
šed iv ě t	RSII
šed ý	RI
šept a l	RIS
šept a t	RII
šept nou t	RII
šetř i t	RII
šid i t	RII
šifr ova n ý	RISI
šifr ova t	RII
šik nou t	RII
šik ova t	RII
šilh a t	RII
šir oc e	RRI
šir ok o	RIS
šir ok ý	RII
škatul k ova t	RIII
škleb i l	RIS
škleb i t	RII
škobrt nou t	RII
škod a	RI
škod i t	RII
škod ova t	RII
škol en í	RSI
škol i t	RII
škol n é	RSI
škol n í	RSI
škol ák	RS
škrob i t	RII
škrt a t	RII
škrt i l	RIS
škrt i t	RII
škrt nou t	RII
škub a t	RII
škub nou t	RII
škub nu t í	RSII
škvař i t	RII
škyt a t	RII
škyt nou t	RII
šlap a t	RII
šlecht a	RI
šlecht i t	RII
šleh á v a t	RSSII
šláp nou t	RII
šmajd a t	RII
šmel i t	RII
šmik nou t	RII
šmodrch a t	RII
šmudl a t	RII
šněr ova t	RII
šoup nou t	RII
šour a t	RII
španěl sk ý	RII
špendl i t	RII
šperk ova t	RII
špik ova t	RII
špin av ý	RSI
špin i t	RII
špič at i t	RSII
špič k a	RII
špič k ova t	RIII
šplh a dl o	RISS
šplh nou t	RII
šplouch a t	RII
šplích a t	RII
špon ova t	RII
šprt a t	RII
šprt k a	RII
šprým ova t	RII
šroub ova t	RII
štv a n ec	RISI
štíp a t	RII
štíp nou t	RII
štít	R
štěbet a t	RII
štěk a t	RII
štěk nou t	RII
štěk nu t í	RSII
štěk á n í	RSSI
štěp i t	RII
štěp n ě	RSI
štěp ova t	RII
štěst í	RI
šum	R
šum ě t	RII
šust i t	RII
švejk ova t	RII
švih a t	RII
švih nou t	RII
švindl ova t	RII
šíř e	RI
šíř i t	RII
šíř k a	RII
šňup a t	RII
šňup nou t	RII
šťast n ý	RSI
šťast n ě	RSI
šťouch a t	RII
šťouch nou t	RII
šťour a t	RII
ťap a t	RII
ťuk a t	RII
ťuk nou t	RII
žab ař	RS
žab í	RI
žad a tel	RIS
žad on i t	RSII
žah a t	RII
žal n ý	RSI
žal ova t	RII
žebr a t	RII
žebr o	RS
žebr on i t	RSII
žebr ova t	RII
žebr ák	RS
žeh a t	RII
žehn a t	RII
žeh nou t	RII
želez n ý	RSI
želíz k o	RIS
žen a	RI
žen at ý	RSI
žen i ch	RII
žen i t	RII
žen sk ý	RII
žert ova t	RII
žert ov n ý	RSSI
žh av i t	RSII
žh av ý	RSI
žh av ě t	RSII
žh nou t	RII
žh ář	RS
žid	R
žil k ova t	RIII
žlout nou t	RII
žlut i t	RII
žlut ý	RI
žmol i t	RII
žmoul a t	RII
žr á t	RSI
žvatl a t	RII
žvýk a t	RII
žáb a	RI
žád a t	RII
žád ost	RS
žád ou c í	RSSI
žíh a t	RII
adres a	RI
andíl ek	RI
anděl í	RI
anim ova t	RII
baf nou t	RII
bagr ova t	RII
bal en í	RSI
bav i t	RII
blb ec	RI
bour a t	RII
bouč ek	RI
bud ouc í	RSI
bydl e n í	RISI
báb a	RI
bíl e	RI
bý v a l ý	RSISI
břich at ě t	RSII
centr ál a	RSI
centr ální	RS
centr ál n ě	RSSI
cest ov á n í	RSSSI
chalup a	RI
charakter	R
charakter ist ik a	RRSI
chlad i t	RII
chlaz en ý	RSI
chláp ek	RI
chop i t	RII
cht í t	RII
chyb a	RI
cink nou t	RII
cit át	RS
ciz í	RI
cour a	RI
ct í t	RII
cíl en ě	RSI
daň	R
de sign ova t	PRII
dimenz e	RI
dlaž b a	RII
dlouž i t	RII
dluž n ý	RSI
dobr o	RS
do bád a t	PRII
dobř e	RI
do hlíd a t	PRII
do hn a t	PRII
do hád a t	PRII
do loud a t	PRII
dol ova t	RII
dom ek	RI
do mák nou t	PRII
do pad á v a t	PRSSII
do plat i t	PRII
do plav a t	PRII
do po ruč en í	PPRSI
do stač ova t	PRII
do střik ova t	PRII
do syt i t	PRII
do sáh nou t	PRII
do taz	PR
do taz ník	PRS
do tlouc i	PRI
do tvář e t	PRII
do tyč n ý	PRSI
do táz a n ý	PRISI
do tír a t	PRII
do tř í t	PRII
do vol en á	PRSS
do zn í v á n í	PRISSSI
do řek nou t	PRII
do ší t	PRI
do žád a t	PRII
do ží v a t	PRSII
drt i č	RIS
drž e n í	RISI
duš en ě	RSI
dvůr	R
dír a	RI
dých a t	RII
děl nic e	RSI
dět in stv í	RSSI
dů chod ov ý	PPPI
figur ova t	RII
film ova t	RII
financ ova t	RII
finanč n ě	RSI
form ova t	RII
has i t	RII
has i č	RIS
hlav at ý	RSI
hliň ák	RS
hloub	R
hlub ok ý	RII
hluč n ý	RSI
hnět en í	RSI
hod i t	RII
hoj i t	RII
hoj n ě	RSI
hor ák	RS
hospod ář	RS
host in sk ý	RSII
hrab a t	RII
hrb at i t	RSII
hrub ý	RI
hrub ě	RI
jádr o	RS
jízd en ka	RSI
kap a t	RII
kapes n íč ek	RSSI
kapitál ov ě	RSI
kas a t	RII
kaz a tel	RIS
kec nou t	RII
keř	R
klad iv o	RSS
kles a t	RII
klid n ě	RSI
klič k ova t	RIII
klopýt nou t	RII
klouz nou t	RII
klíč n í	RSI
knih a	RI
kolís a t	RII
kol íč k ova t	RSIII
kombin ova t	RII
koneč n ý	RSI
kontrol ová n í	RSSI
kon á n í	RSSI
konč i t	RII
kouk nou t	RII
koum a t	RII
koup ac í	RSI
kož eš in ov ý	RRSSI
král	R
krám ova t	RII
krás n ý	RSI
káp nou t	RII
kých a t	RII
kýv nou t	RII
křest	R
křt í t	RII
lak ova t	RII
led nic ovit ý	RSSI
led ov at ě t	RSSII
les	R
let ě t	RII
lh á t	RSI
lid	R
lid sk ý	RII
liš i t	RII
loup ež	RS
lyž ař	RS
lék ař sk ý	RSII
líst eček	RS
lít o	RS
líz nou t	RII
magnet	R
mal ý	RI
map ka	RI
mar n i t	RSII
mek a t	RII
minister stv o	RSS
model ova t	RII
modul ova t	RII
motiv	R
muzik ant	RS
muzik ant sk ý	RSII
muž stv o	RSS
myš	R
mín it	RI
mín ěn ý	RSI
měd i t	RII
měk k o	RIS
měk č i t	RSII
měř en í	RSI
měř i t	RII
mříž ova t	RII
mříž ov ec	RSI
na bloud i t	PRII
na checht a t	PRII
na chyl ova t	PRII
na dou v a t	PRSII
nad zdvih ova t	PRII
na hlas	PR
na hlod á v a t	PRSSII
na hod i t	PRII
na kaz ova t	PRII
na kaž li v ý	PRRSI
na krout i t	PRII
na kus ova t	PRII
na kuř ova t	PRII
na léz t	PRI
na plň ova t	PRII
na pích á v a t	PRSSII
na soud i t	PRII
na stá v a t	PRSII
na stěh ova t	PRII
na tah a t	PRII
na třísk a t	PRII
na vaz ová n í	PRSSI
na vrch	PR
na vrh nou t	PRII
na vrš i t	PRII
na véz t	PRI
na víj e t	PRII
na věš ova t	PRII
na čich nou t	PRII
na řík a t	PRII
na šept á v a t	PRSSII
na škub a t	PRII
na šňup nou t	PRII
na žert ova t	PRII
ne bý v a l e	PRSISI
ne jas n ý	PRSI
ne po zor ova n ost	PPRISS
ne ruš en ě	PRSI
noc ova t	RII
nouz e	RI
novel a	RI
nov áč ek	RSI
nuc en ě	RSI
nut n ost	RSS
ná jem	PR
ná jezd	PR
ná skok	PR
ná sled ov n ě	PRSSI
ná sled uj íc í	PRSSI
ná zev	PR
ná znak	PR
obec n ě	RSI
ob jedn a t	PRII
ob je t	PRI
ob měk č ova t	PRSII
ob naž i t	PRII
ob nov i t	PRII
o brous i t	PRII
ob ráž e t	PRII
ob star á v a t	PRSSII
ob tíž n ě	PRSI
ob vaz ova t	PRII
o bydl e t	PRII
o by v a tel stv o	PRSISSS
ob čas	PR
obět ova t	RII
ob šláp nou t	PRII
o chod i t	PPII
o chur av ě t	PRSII
od barv ova t	PRII
od brzď ova t	PRII
ode t nou t	PIII
od hrab ova t	PRII
od je t	PRI
od kap á v a t	PRSSII
od klop i t	PRII
od koléb a t	PRII
od kop nou t	PRII
od káp nou t	PRII
od káz a t	PRII
od lí v a t	PRSII
od měn a	PRI
od měn i t	PRII
od ním a t	PRII
od oper ová v a t	PRSSII
od po věd ě t	PPRII
od pud i t	PRII
od pár a t	PRII
od při sáh nou t	PPRII
od raz	PR
od ruš i t	PRII
od sed ě t	PRII
od straš i t	PRII
od strč i t	PRII
od trh a t	PRII
od trh á v a t	PRSSII
o dus i t	PRII
od vol a t	PRII
od vol i t	PRII
od váb i t	PRII
od řez a t	PRII
od říz nou t	PRII
od špendl i t	PRII
o hlaz ova t	PRII
o hmat á v a t	PRSSII
o hrom n ý	PRSI
o hrom n ě	PRSI
o hryz á v a t	PRSSII
o hří v a t	PRSII
o klam a t	PRII
o kol í	PRI
o krád a t	PRII
o křik nou t	PRII
o mdl é v a t	PRISII
o mez i t	PRII
o myl	PR
o ploz ova t	PRII
o po vrh ova t	PPRII
o po vrž liv ě	PPRSI
o prac ova t	PRII
o praž i t	PRII
o slep nou t	PRII
o tes a t	PRII
o tup ova t	PRII
o vad nou t	PRII
o zlat i t	PRII
o čenich a t	PRII
o čes á v a t	PRSSII
o řez á v a t	PRSSII
o říz nou t	PRII
o škub á v a t	PRSSII
o ší v a t	PRSII
pan	R
pan ičk a	RSI
pat a	RI
patr n ě	RSI
paž i t	RII
pejs án ek	RSI
peč l iv ě	RSSI
plac en ý	RSI
plod i t	RII
plod n ost	RSS
plot	R
plán ova t	RII
plýtv a t	RII
po bruč ova t	PRII
po by t	PRI
po chlub i t	PRII
po chop i teln ě	PRISI
po chyt i t	PRII
pod ceň ova t	PRII
pode zd í v a t	PRISII
pod lom i t	PRII
pod mal ova t	PRII
pod miň ova t	PRII
pod nik a tel	PRIS
pod pír a t	PRII
pod sek nou t	PRII
pod ték a t	PRII
po děl a n ý	PRISI
po děl i t	PRII
pod řez á v a t	PRSSII
po dřim ova t	PRII
po hromad ě	PRI
po hrá v a t	PRSII
po hvizd ova t	PRII
po hřb í v a t	PRISII
po jist i t	PRII
po jist n é	PRSI
po jišť ovn a	PRSI
po jíd a t	PRII
po kašl á v a t	PRSSII
po kles nou t	PRII
po kláp ě t	PRII
po křiž ova t	PRII
po křt í t	PRII
po loh a	PRI
po lož i t	PRII
po líč i t	PRII
po mlask á v a t	PRSSII
po moc i	PRI
po muchl ova t	PRII
po měr	PR
po mř í t	PRII
po ob vesel i t	PPRII
po po je t	PPRI
po po strk ova t	PPRII
po po táh nou t	PPRII
po pt á v k a	PRSSII
po přá v a t	PRSII
po rad i t	PRII
po rad k yn ě	PRISI
po rovn a t	PRII
portrét ova t	RII
po skyt uj íc í	PRSSI
po soud i t	PRII
po sr á v a t	PRSSII
po star a t	PRII
po stá v a t	PRSII
po stýsk á v a t	PRSSII
po střel i t	PRII
potenc iál n í	RSSI
po trat i t	PRII
po trav in ář sk ý	PRSSII
po tír a t	PRII
po třeb a	PRI
po třás t	PRI
po uč en í	PRSI
poušt n í	RSI
pouť	R
po u ží v a n ý	PPRSISI
po val ova t	PRII
po vol i t	PRII
po vrh ova t	PRII
po vy stoup i t	PPRII
po vy tah ova t	PPRII
po vy táh nou t	PPRII
po vz dech nou t	PPRII
po vz dych ova t	PPRII
po za vír a t	PPRII
po zdrav i t	PRII
po zor n ost	PRSS
po zor n ě	PRSI
po zor ová n í	PRSSI
po řád a t	PRII
po šept a t	PRII
po škoz en í	PRSI
po šlap a t	PRII
po šlap á v a t	PRSSII
po ší t	PRI
po žad a v ek	PRISI
po žád a t	PRII
prac ov n a	RSSI
prac ov nic e	RSSI
pras e č i t	RISII
prezent ac e	RSI
prezent ova t	RII
pro bád a t	PRII
pro debat ova t	PRII
pro hloub i t	PRII
pro hmat a t	PRII
pro hrab a t	PRII
pro hráb nou t	PRII
pro hří v a t	PRSII
pro jedn á v á n í	PRSSSSI
pro klouz á v a t	PRSSII
pro kmit a t	PRII
pro kuř ova t	PRII
pro mar n i t	PRSII
pro maz á v a t	PRSSII
pro mrsk a t	PRII
pro ná jem	PPR
pro pr a t	PRII
pro pás t	PRI
pro pék a t	PRII
pro tanč i t	PRII
pro trh nou t	PRII
pro trh á v a t	PRSSII
pro ték a t	PRII
pro véz t	PRI
pro říz nou t	PRII
prýsk a t	RII
prů mysl	PR
ps a n í	RISI
páj e t	RII
pár	R
péč e	RI
pích nou t	RII
písk ova t	RII
pě t	RI
pře brous i t	PRII
pře buj e t	PRII
pře cez ova t	PRII
pře chýl i t	PRII
pře cvič i t	PRII
přede pis ova t	PRII
před n ost	PPP
před náš e t	PRII
před n ě	PPI
před paž i t	PRII
před po věd ě t	PPRII
před vol a t	PRII
pře hmát nou t	PRII
pře hobl ova t	PRII
pře jís t	PRI
pře kap a t	PRII
pře kom pon ova t	PRRII
pře kořen i t	PRII
pře kruc ova t	PRII
pře křik nou t	PRII
pře křik ova t	PRII
pře křt í t	PRII
pře let ě t	PRII
pře most i t	PRII
pře mož i tel	PRIS
pře máh a t	PRII
pře pad nou t	PRII
pře plác a t	PRII
pře pál i t	PRII
pře ruš ova t	PRII
pře sch nou t	PRII
pře straš i t	PRII
pře tah ova t	PRII
pře tř í t	PRII
pře uč i t	PRII
pře val ova t	PRII
pře vlád nou t	PRII
pře ví v a t	PRSII
pře zou v a t	PRSII
pře čerp a t	PRII
pře škol en í	PRSI
pře šlap a t	PRII
při barv ova t	PRII
při chýl i t	PRII
při drž e t	PRII
při drž ova t	PRII
při děl á v a t	PRSSII
při frč e t	PRII
při hlás i t	PRII
při hrá v a t	PRSII
při ház e t	PRII
při klep á v a t	PRSSII
při kom pon ova n ý	PRRISI
při koul e t	PRII
při krý t	PRI
při kup ova t	PRII
při káz á n í	PRSSI
při lét á v a t	PRSSII
při léz t	PRI
při lí t	PRI
při nož ova t	PRII
při náš e t	PRII
při pevn i t	PRII
při plíž i t	PRII
při pál i t	PRII
při pích nou t	PRII
při stroj i t	PRII
při stup ova t	PRII
při sun ova t	PRII
při tisk nu t ý	PRSII
při táh nou t	PRII
při těž uj íc í	PRSSI
při uč i t	PRII
při vaz ova t	PRII
při věs i t	PRII
při zn a t	PRII
při čich nou t	PRII
při čin ěn í	PRSI
při šoup nou t	PRII
přís t	RI
pří štip k ova t	PRIII
půjč ova t	RII
radikál n ě	RSI
real it n í	RISI
relac e	RI
relat ivn ě	RSI
roz brázd i t	PRII
roz buj n ě t	PRSII
roz cuch a t	PRII
roz drb a t	PRII
roz díl e t	PRII
roz děl ova t	PRII
roze rv a t	PRII
roz has i t	PRII
roz hněv a t	PRII
roz host i t	PRII
roz houk á v a t	PRSSII
roz hr nou t	PRII
roz ház en ý	PRSI
roz hřeš i t	PRII
roz kaz ova t	PRII
roz kmit a t	PRII
roz kop á v a t	PRSSII
roz kýv a t	PRII
roz lam ova t	PRII
roz loup á v a t	PRSSII
roz lé v a t	PRSII
roz moc i	PRI
roz mrz e t	PRII
roz máz nou t	PRII
roz měk nou t	PRII
roz por	PR
roz prch a t	PRII
roz pě t í	PRII
roz půl i t	PRII
roz svěc e t	PRII
roz tanc ova t	PRII
roz tep á v a t	PRSSII
roz trh nou t	PRII
roz ték a t	PRII
roz těk á v a t	PRSSII
roz um ová n í	PRSSI
roz vař i t	PRII
roz vesel ova t	PRII
roz vikl a t	PRII
roz vléc i	PRI
roz vlň ova t	PRII
roz víř i t	PRII
roz věš e t	PRII
roz čar ova t	PRII
roz čechr á v a t	PRSSII
roz řad i t	PRII
roz škrt nou t	PRII
rám ova t	RII
rýp nou t	RII
s bal ova t	PRII
s chov a t	PRII
s chvál n ě	PRSI
s děl a t	PRII
s děl ová n í	PRSSI
se hn a t	PRII
se hrá v a t	PRSII
se sch nou t	PRII
se skak ova t	PRII
se steh ova t	PRII
se řez á v a t	PRSSII
se šlap á v a t	PRSSII
se šněr ova t	PRII
s hled a n á	PRISS
s ház e t	PRII
sil n ič n í	RSSSI
s jedn a t	PRII
s kap á v a t	PRSSII
s klad	PR
skl en ář sk ý	RSSII
s klid i t	PRII
s klič ova t	PRII
s kon a t	PRII
s kop a t	PRII
skák a t	RII
sled	R
s los ova t	PRII
s los ová n í	PRSSI
s loup á v a t	PRSSII
s lož en í	PRSI
sluš e t	RII
slíd i t	RII
slých a t	RII
s mršť ova t	PRII
s mysl i t	PRII
s mích á v a t	PRSSII
s nís t	PRI
sn í t	RII
s nýt ova t	PRII
sněž i t	RII
soud c e	RSI
s pln ěn í	PRSI
s plác nou t	PRII
sport	R
s po třeb a	PPRI
s po třeb ová v a t	PPRSSII
s péc i	PRI
s rovn á v á n í	PRSSSSI
s tah a t	PRII
star ý	RI
s tisk a t	PRII
strach	R
stroj n í	RSI
strouh nou t	RII
stá v a t	RSII
svobod a	RI
s vol i t	PRII
svět sk ý	RII
symbol iz ova t	RSII
síl i t	RII
s říz nou t	PRII
tanč i t	RII
test ova t	RII
tlak	R
totál n í	RSI
trumf ova t	RII
trysk ov ý	RSI
trén ova t	RII
trž i t	RII
trž n ě	RSI
tuž b a	RII
tvrd ě	RI
téc i	RI
třep a t	RII
tříb i t	RII
tř í t	RII
u cp a t	PRII
u has nou t	PRII
u hlad i t	PRII
u hřá t	PRI
u kamen ova t	PRII
u kořist ěn ý	PRSI
u krát i t	PRII
u lam ova t	PRII
ulič k a	RII
u lí v a t	PRSII
u met a t	PRII
u mř í t	PRII
u nos i t	PRII
u nés t	PRI
u pad nou t	PRII
u pín a t	PRII
u raz i t	PRII
u skak ova t	PRII
u skoč i t	PRII
u smol i t	PRII
u s mysl i t	PPRII
u stá v a t	PRSII
u tlesk a t	PRII
u t nou t	PIII
u vid ě t	PRII
u za vř í t	PPRII
u zn a t	PRII
u zn á v aj íc í	PRSSSSI
u zá kon i t	PPRII
u čar ova t	PRII
u šetř i t	PRII
u šlap a t	PRII
u štip ova t	PRII
vad a	RI
v bod á v a t	PRSSII
ven	R
ven k ov	RIS
ven k ovn í	RISI
verš	R
verš ova t	RII
vesel i t	RII
ves nic k ý	RSII
vidl ic e	RSI
vid ě t	RII
v kap á v a t	PRSSII
v klad	PR
v káp nou t	PRII
vlast n ost	RSS
vlh nou t	RII
vlád a	RI
vláč n ě t	RSII
v lí v a t	PRSII
vol b a	RII
von ě t	RII
v prav ova t	PRII
vrz a t	RII
vrš i t	RII
v souk a t	PRII
v tlouk a t	PRII
v trh nou t	PRII
vy baf nou t	PRII
vy barv i t	PRII
vy bav i t	PRII
vy blýsk nou t	PRII
vy buch nou t	PRII
vy cuc nou t	PRII
vy doj i t	PRII
vy draž i t	PRII
vy děl a t	PRII
vy fouk nou t	PRII
vy gum ova t	PRII
vy hled a t	PRII
vy hod i t	PRII
vy hrab a t	PRII
vy hrab ova t	PRII
vy hrab ová n í	PRSSI
vy hrab á v a t	PRSSII
vy jev ova t	PRII
vy jmen ova t	PRII
vy kous a t	PRII
vy kram ař i t	PRSII
vy krop i t	PRII
vy kul i t	PRII
vy kvés t	PRI
vy káp nou t	PRII
vy křič e t	PRII
vy los ova t	PRII
vy louh ova t	PRII
vy mačk á v a t	PRSSII
vy mír a t	PRII
vy mý v a t	PRSII
vy měř ova t	PRII
vy na jí t	PPRI
vy plav a t	PRII
vy plav i t	PRII
vy plň ova t	PRII
vy po slech nou t	PPRII
vy po řád á v a t	PPRSSII
vy pék a t	PRII
vy rýp á v a t	PRSSII
vy růst a t	PRII
vy sek a n ý	PRISI
vy sek á v a t	PRSSII
vy sn í t	PRII
vys oc e	RRI
vy strk a t	PRII
vy stup ová n í	PRSSI
vy stá t	PRI
vy tah a n ý	PRISI
vy trub ova t	PRII
vy trv a t	PRII
vy trén ova t	PRII
vy tvoř i t	PRII
vy uč en í	PRSI
vy vol á v a c í	PRSSISI
vy véz t	PRI
vy víj e t	PRII
vy věs i t	PRII
vy zdvih nou t	PRII
vy zim ova t	PRII
vy zlat i t	PRII
vy zob nou t	PRII
vy čišt ěn ý	PRSI
vy řaď ova t	PRII
vy řeš i t	PRII
vy řít i t	PRII
vy říz en ý	PRSI
vy šetř en í	PRSI
vy šetř i t	PRII
vy šetř ová n í	PRSSI
vy šperk ova t	PRII
vy žad ova t	PRII
vy žr a t	PRII
vz buz ova t	PRII
vz dou v a t	PRSII
vz pla nou t	PRII
vz ruš e n ě	PRISI
vý děl ek	PRI
vý křik	PR
vý rob n a	PRSI
vý uk a	PRI
věr n ě	RSI
větr a t	RII
všim nou t	RII
v šoup nou t	PRII
za barv i t	PRII
za barv ova t	PRII
za blok ova t	PRII
za bloud i t	PRII
za bouch a t	PRII
za checht a t	PRII
za clán ě t	PRII
za dlab a t	PRII
za drát ova t	PRII
za drž e t	PRII
za dých a t	PRII
za han b ova t	PRIII
za hnízd i t	PRII
za hrab á v a t	PRSSII
za hryz á v a t	PRSSII
za hák nou t	PRII
za jišť uj íc í	PRSSI
za jím a t	PRII
za jím a v ost	PRISS
za jížd ě t	PRII
za klič k ova t	PRIII
za klon i t	PRII
za klán ě t	PRII
za koup en í	PRSI
za lam ova t	PRII
za lét á v a t	PRSSII
za lí v a t	PRSII
za maz á v a t	PRSSII
za mlask a t	PRII
za mlč e t	PRII
za modr a t	PRII
za mysl i t	PRII
za měn i t	PRII
za ostř i t	PRII
za paž ova t	PRII
za plň ova t	PRII
za pušt ěný	PRR
za pách a t	PRII
za rost l ý	PRSI
za sek nou t	PRII
za skl í t	PRII
za smrk a t	PRII
za smá t	PRI
za sol i t	PRII
za stl a t	PRII
za stud i t	PRII
za sun ova t	PRII
za svět él k ova t	PRSIII
za taj ova t	PRII
za tmel i t	PRII
za tm í t	PRII
za téc i	PRI
za těk a t	PRII
za va nou t	PRII
za vař i t	PRII
za vikl a t	PRII
za vod ň ova t	PRSII
za vrh nou t	PRII
za vrh ova t	PRII
za váz a t	PRII
za véz t	PRI
za zář i t	PRII
za čar ova t	PRII
za čp ě t	PRII
za řeht a t	PRII
za řez a t	PRII
za říz nu t ý	PRSII
za škleb i t	PRII
za škol ová n í	PRSSI
za štíp a t	PRII
za žal ova t	PRII
za žeh nou t	PRII
za žád a t	PRII
z běl e t	PRII
z chud nou t	PRII
z chyst a t	PRII
z ciz i t	PRII
z dan ěn í	PRSI
zdrav ot nic k ý	RSSII
z dřev ěn ě t	PRSII
zelen i t	RII
zem ě	RI
ze mř í t	PRII
ze smut n ě t	PRSII
ze stár nou t	PRII
z film ova t	PRII
z hlt a t	PRII
z jedn a t	PRII
z jedn á v a t	PRSSII
z jev ova t	PRII
z kap a t	PRII
z kruš i t	PRII
z kuš eb n í	PRSSI
z lid št ě t	PRSII
z mechan iz ova t	PRSII
z mls a t	PRII
z mám i t	PRII
z měk č i t	PRSII
z měn i t	PRII
z ne svěc ova t	PPRII
z ne u zn á v á n í	PPPRSSSSI
z ne čisť ová n í	PPRSSI
z ne čišť uj íc í	PPRSSI
z ne škod n i t	PPRSII
zob ák	RS
zob á n í	RSSI
z od po věd ě t	PPPRII
z orient ova t	PRII
zouf nou t	RII
z plesn iv ě t	PRSII
z popel ň ova t	PRSII
z pře ráž e t	PPRII
z pře vrac ova t	PPRII
zrn k o	RIS
z rub a t	PRII
z rýh ova t	PRII
z růž ov ě t	PRSII
z tav i t	PRII
z tm av ě t	PRSII
z trac en o	PRSS
z trh nou t	PRII
z tvrd nou t	PRII
z třísk a t	PRII
z u ráž e t	PPRII
z verš ova t	PRII
z vikl á v a t	PRSSII
z vyš ova t	PRII
zád a	RI
zá jem c e	PRSI
zá vid ě t	PRII
zá vrať	PR
z ú čast ň ova t	PPRSII
z řek nou t	PRII
z řez a t	PRII
z říd i t	PRII
z šed iv ě t	PRSII
ú hlav n í	PRSI
ú čast ník	PRS
ú čin n ě	PRSI
čad i t	RII
čar ova t	RII
čel o	RS
čet n ík	RSS
čist ý	RI
člán ek	RI
řad a	RI
řeč n i t	RSII
řeš i teln ý	RISI
říd k ý	RII
říz nou t	RII
šerm ova t	RII
škobrt a t	RII
šleh nou t	RII
šmik a t	RII
šoup á n í	RSSI
špič k ov ý	RISI
šplích nou t	RII
šíp	R
ťap k a t	RIII
žvan i t	RII
adapt abil n í	RSSI
bal en ý	RSI
bok	R
box	R
bud ova	RI
cen ík	RS
chléb	R
chrán i t	RII
chyb ěj íc í	RRSI
cháp a t	RII
couv nou t	RII
div ák	RS
do drž ová n í	PRSSI
do hromad y	PRI
do plac en í	PRSI
do pln i t	PRII
do plác e t	PRII
do po máh a t	PPRII
děl en í	RSI
dů chod	PP
falš ova t	RII
funkč n í	RSI
gener ac e	RSI
hlad	R
hud eb n í	RSSI
in form ova t	PRII
jedn ot liv in a	RSSSI
kles aj íc í	RSSI
kost n í	RSI
kraj	R
krv av ě t	RSII
kry t ý	RII
krám	R
kup uj íc í	RSSI
kšeft	R
let išt ě	RSI
limit	R
líst ek	RI
mal ič k ý	RSII
mast	R
maz á n í	RSSI
meč e n í	RISI
mil ost	RS
min ul ý	RSI
mluv íc í	RSI
mont áž	RS
míst n í	RSI
na by t í	PRII
na dš en í	PRSI
na kol k ova t	PRIII
na vy práv ě t	PPRII
ne moc n ý	PRSI
ne štěst í	PRI
nul a	RI
ná by tek	PRR
ná stroj	PR
návštěv a	RI
návštěv n ost	RSS
ob sah uj íc í	PRSSI
o chran k a	PRII
od chyl k a	PRII
od lož en í	PRSI
od po víd a t	PPRII
od řík a t	PRII
od štěp ova t	PRII
o hlod a t	PRII
o mez ová n í	PRSSI
o plod ň ova t	PRSII
o sp a l ost	PRISS
o svoboz en í	PRSI
ote vř í t	RRII
o trav ova t	PRII
o vlád á n í	PRSSI
o ví t	PRI
o věř i t	PRII
pan en k a	RSII
peníz	R
plac en í	RSI
plat b a	RII
pln ěn í	RSI
po klad	PR
po klep a t	PRII
po krout i t	PRII
po plat ník	PRS
po rovn ání	PRS
po stih	PR
po suz ová n í	PRSSI
po síl en í	PRSI
po vz dych nou t	PPRII
po víd k a	PRII
po čas í	PRI
po řad a tel	PRIS
po řád á n í	PRSSI
pro duc ent	PRR
pro děl a t	PRII
pro děl ek	PRI
pro hlíž e t	PRII
pro klábos i t	PRII
pro lam ova t	PRII
propag ac e	RSI
pro trh a t	PRII
práv e m	RII
práv o	RS
prů běh	PR
prů mysl ov ě	PRSI
pump nou t	RII
pách a t	RII
před cház e t	PPII
před lož i t	PRII
před vý rob n í	PPRSI
pře hrad a	PRI
pře roub ova t	PRII
přesn ost	RS
pře střel i t	PRII
při cház e t	PPII
při vy děl á v a t	PPRSSII
pří zem í	PRI
rad a	RI
roh áč ek	RSI
roz drt i t	PRII
roz děl en í	PRSI
roz hlas	PR
roz jížd ě t	PRII
roz lož i t	PRII
roz mot a t	PRII
roz paž i t	PRII
roz prask nou t	PRII
roz šiř ová n í	PRSSI
ruč k ova t	RIII
rán a	RI
různ ě	RI
s bratř i t	PRII
scén a	RI
sek nou t	RII
se strk á v a t	PRSSII
s kas a t	PRII
s konč en í	PRSI
slav n ost n ě	RSSSI
sled ová n í	RSSI
slun c e	RSI
slyš e t	RII
sou boj	PR
sou vis l ost	PRSS
s pln i t	PRII
sport ov n í	RSSI
s po třeb i tel	PPRIS
s roz um i teln ě	PPRISI
stabil n í	RSI
star a t	RII
star ob n í	RSSI
start	R
sta v en í	RSSI
s trav a	PRI
stud ent	RR
stud ij n í	RSSI
stud ova n ý	RISI
stůl	R
super dobr ý	PRI
svět ov ě	RSI
system at ic k ý	RSSII
techn ik a	RSI
tip nou t	RII
trž b a	RII
táh l o	RSS
týr a t	RII
u jist i t	PRII
u lov i t	PRII
u plat i t	PRII
u pích a t	PRII
urč it ě	RII
uč i tel	RIS
u žmoul a t	PRII
u ží v a t	PRSII
večer	R
v mysl i t	PRII
v stup	PR
v stup enk a	PRSI
v stup n é	PRSI
vy drážd i t	PRII
vy dých nou t	PRII
vy na lož i t	PPRII
vy pro vok ova t	PPRII
vys ok á	RIS
vy sp ink a t	PRSII
vy stoup en í	PRSI
vy stoup i t	PRII
vy síl a c í	PRISI
vy z vrac e t	PPRII
vy řík a t	PRII
vz děl án í	PRSI
válk a	RI
vítěz ství	RS
větr ovk a	RSI
za houk a t	PRII
za hr nu t í	PRSII
za jist i t	PRII
za kop a n ý	PRISI
za kýv a t	PRII
za mal ova t	PRII
za perl i t	PRII
za syp a n ý	PRISI
za věš en í	PRSI
z dřev n at ě t	PRSSII
z falš ová n í	PRSSI
z jist i t	PRII
z kouš e t	PRII
z modr a t	PRII
z pě v a č k a	PRSISII
z ruš en í	PRSI
z vrát i t	PRII
zá sob en í	PRSI
zá sob ová n í	PRSSI
zá stup c e	PRSI
ú prav a	PRI
ú čast n ě	PRSI
čin i t	RII
čtvrt	R
řez á n í	RSSI
řeš i t	RII
řád n ě	RSI
šed iv ý	RSI
škol a	RI
žehl i t	RII
